RNTIs_DL,numDLTotal,numDLnew,numReTx_DL,avgMCS_DL,numULTotal,numULnew,numReTx_UL,avgMCS_UL,PulseWidth,PulseWidthSlotIdx,TTI
1,91,79,12,5,89,74,15,5,230,312,4
2,120,96,24,5,93,77,16,5,230,312,4
3,121,104,17,5,93,75,18,5,230,312,4
4,130,107,23,5,101,78,23,5,230,312,4
5,117,92,25,5,93,73,20,5,230,312,4
6,110,92,18,5,89,75,14,5,230,312,4
7,90,72,18,5,87,74,13,5,230,312,4
8,89,72,17,5,93,77,16,5,230,312,4
9,104,85,19,5,88,77,11,5,230,312,4
10,110,93,17,5,92,76,16,5,230,312,4
1,98,79,19,5,90,75,15,5,15,2297,4
2,101,85,16,5,94,78,16,5,15,2297,4
3,119,100,19,5,92,76,16,5,15,2297,4
4,119,98,21,5,96,77,19,5,15,2297,4
5,121,96,25,5,92,77,15,5,15,2297,4
6,113,95,18,5,89,74,15,5,15,2297,4
7,89,73,16,5,89,75,14,5,15,2297,4
8,105,82,23,5,97,75,22,5,15,2297,4
9,99,86,13,5,94,78,16,5,15,2297,4
10,114,94,20,5,91,77,14,5,15,2297,4
1,91,79,12,5,89,74,15,5,123,3727,4
2,120,96,24,5,93,77,16,5,123,3727,4
3,121,104,17,5,93,75,18,5,123,3727,4
4,130,107,23,5,101,78,23,5,123,3727,4
5,117,92,25,5,93,73,20,5,123,3727,4
6,110,92,18,5,89,75,14,5,123,3727,4
7,90,72,18,5,87,74,13,5,123,3727,4
8,89,72,17,5,93,77,16,5,123,3727,4
9,104,85,19,5,88,77,11,5,123,3727,4
10,110,93,17,5,92,76,16,5,123,3727,4
1,98,79,19,5,90,75,15,5,235,2108,4
2,101,85,16,5,94,78,16,5,235,2108,4
3,119,100,19,5,92,76,16,5,235,2108,4
4,119,98,21,5,96,77,19,5,235,2108,4
5,121,96,25,5,92,77,15,5,235,2108,4
6,113,95,18,5,89,74,15,5,235,2108,4
7,89,73,16,5,89,75,14,5,235,2108,4
8,105,82,23,5,97,75,22,5,235,2108,4
9,99,86,13,5,94,78,16,5,235,2108,4
10,114,94,20,5,91,77,14,5,235,2108,4
1,98,79,19,5,90,75,15,5,213,2657,4
2,101,85,16,5,94,78,16,5,213,2657,4
3,119,100,19,5,92,76,16,5,213,2657,4
4,119,98,21,5,96,77,19,5,213,2657,4
5,121,96,25,5,92,77,15,5,213,2657,4
6,113,95,18,5,89,74,15,5,213,2657,4
7,89,73,16,5,89,75,14,5,213,2657,4
8,105,82,23,5,97,75,22,5,213,2657,4
9,99,86,13,5,94,78,16,5,213,2657,4
10,114,94,20,5,91,77,14,5,213,2657,4
1,52,37,15,5,65,49,16,5,420,3375,4
2,63,42,21,5,69,56,13,5,420,3375,4
3,56,38,18,5,88,67,21,5,420,3375,4
4,45,33,12,5,78,65,13,5,420,3375,4
5,53,33,20,5,86,61,25,5,420,3375,4
6,63,38,25,5,85,66,19,5,420,3375,4
7,49,34,15,5,76,63,13,5,420,3375,4
8,52,32,20,5,67,50,17,5,420,3375,4
9,65,35,30,5,62,49,13,5,420,3375,4
10,59,35,24,5,59,46,13,5,420,3375,4
1,92,78,14,5,88,75,13,5,273,1810,4
2,119,96,23,5,93,75,18,5,273,1810,4
3,114,99,15,5,94,74,20,5,273,1810,4
4,118,100,18,5,94,77,17,5,273,1810,4
5,122,97,25,5,94,77,17,5,273,1810,4
6,122,99,23,5,90,72,18,5,273,1810,4
7,104,82,22,5,92,75,17,5,273,1810,4
8,85,69,16,5,93,77,16,5,273,1810,4
9,104,84,20,5,87,77,10,5,273,1810,4
10,109,94,15,5,93,77,16,5,273,1810,4
1,60,37,23,5,91,73,18,5,477,1794,4
2,66,40,26,5,92,69,23,5,477,1794,4
3,77,43,34,5,90,64,26,5,477,1794,4
4,64,39,25,5,86,61,25,5,477,1794,4
5,62,36,26,5,84,60,24,5,477,1794,4
6,76,48,28,5,73,49,24,5,477,1794,4
7,73,43,30,5,77,56,21,5,477,1794,4
8,66,45,21,5,93,70,23,5,477,1794,4
9,65,39,26,5,91,72,19,5,477,1794,4
10,59,33,26,5,93,71,22,5,477,1794,4
1,98,79,19,5,90,75,15,5,204,3685,4
2,101,85,16,5,94,78,16,5,204,3685,4
3,119,100,19,5,92,76,16,5,204,3685,4
4,119,98,21,5,96,77,19,5,204,3685,4
5,121,96,25,5,92,77,15,5,204,3685,4
6,113,95,18,5,89,74,15,5,204,3685,4
7,89,73,16,5,89,75,14,5,204,3685,4
8,105,82,23,5,97,75,22,5,204,3685,4
9,99,86,13,5,94,78,16,5,204,3685,4
10,114,94,20,5,91,77,14,5,204,3685,4
1,98,79,19,5,90,75,15,5,187,1612,4
2,101,85,16,5,94,78,16,5,187,1612,4
3,119,100,19,5,92,76,16,5,187,1612,4
4,119,98,21,5,96,77,19,5,187,1612,4
5,121,96,25,5,92,77,15,5,187,1612,4
6,113,95,18,5,89,74,15,5,187,1612,4
7,89,73,16,5,89,75,14,5,187,1612,4
8,105,82,23,5,97,75,22,5,187,1612,4
9,99,86,13,5,94,78,16,5,187,1612,4
10,114,94,20,5,91,77,14,5,187,1612,4
1,98,79,19,5,90,75,15,5,49,3315,4
2,101,85,16,5,94,78,16,5,49,3315,4
3,119,100,19,5,92,76,16,5,49,3315,4
4,119,98,21,5,96,77,19,5,49,3315,4
5,121,96,25,5,92,77,15,5,49,3315,4
6,113,95,18,5,89,74,15,5,49,3315,4
7,89,73,16,5,89,75,14,5,49,3315,4
8,105,82,23,5,97,75,22,5,49,3315,4
9,99,86,13,5,94,78,16,5,49,3315,4
10,114,94,20,5,91,77,14,5,49,3315,4
1,52,34,18,5,61,48,13,5,486,2626,4
2,68,40,28,5,74,59,15,5,486,2626,4
3,56,37,19,5,68,54,14,5,486,2626,4
4,50,38,12,5,77,62,15,5,486,2626,4
5,47,32,15,5,74,62,12,5,486,2626,4
6,62,40,22,5,64,53,11,5,486,2626,4
7,48,31,17,5,87,65,22,5,486,2626,4
8,55,33,22,5,85,67,18,5,486,2626,4
9,55,32,23,5,83,64,19,5,486,2626,4
10,57,33,24,5,92,68,24,5,486,2626,4
1,57,42,15,5,70,53,17,5,314,819,4
2,62,46,16,5,73,56,17,5,314,819,4
3,71,48,23,5,74,60,14,5,314,819,4
4,80,47,33,5,82,65,17,5,314,819,4
5,54,37,17,5,66,51,15,5,314,819,4
6,60,39,21,5,83,61,22,5,314,819,4
7,59,41,18,5,57,45,12,5,314,819,4
8,51,35,16,5,71,60,11,5,314,819,4
9,55,36,19,5,71,57,14,5,314,819,4
10,56,36,20,5,79,55,24,5,314,819,4
1,98,79,19,5,90,75,15,5,43,2198,4
2,101,85,16,5,94,78,16,5,43,2198,4
3,119,100,19,5,92,76,16,5,43,2198,4
4,119,98,21,5,96,77,19,5,43,2198,4
5,121,96,25,5,92,77,15,5,43,2198,4
6,113,95,18,5,89,74,15,5,43,2198,4
7,89,73,16,5,89,75,14,5,43,2198,4
8,105,82,23,5,97,75,22,5,43,2198,4
9,99,86,13,5,94,78,16,5,43,2198,4
10,114,94,20,5,91,77,14,5,43,2198,4
1,50,35,15,5,67,52,15,5,444,2899,4
2,59,38,21,5,72,57,15,5,444,2899,4
3,52,36,16,5,71,57,14,5,444,2899,4
4,42,34,8,5,76,62,14,5,444,2899,4
5,58,34,24,5,67,57,10,5,444,2899,4
6,64,42,22,5,70,56,14,5,444,2899,4
7,52,30,22,5,84,60,24,5,444,2899,4
8,48,31,17,5,77,60,17,5,444,2899,4
9,64,37,27,5,86,68,18,5,444,2899,4
10,60,34,26,5,81,60,21,5,444,2899,4
1,58,43,15,5,67,50,17,5,389,1737,4
2,73,45,28,5,74,57,17,5,389,1737,4
3,55,40,15,5,81,61,20,5,389,1737,4
4,59,42,17,5,75,62,13,5,389,1737,4
5,77,43,34,5,70,55,15,5,389,1737,4
6,46,34,12,5,77,60,17,5,389,1737,4
7,56,35,21,5,74,60,14,5,389,1737,4
8,49,31,18,5,62,49,13,5,389,1737,4
9,54,34,20,5,72,56,16,5,389,1737,4
10,55,35,20,5,82,61,21,5,389,1737,4
1,61,42,19,5,87,66,21,5,497,1167,4
2,54,34,20,5,77,63,14,5,497,1167,4
3,59,39,20,5,72,59,13,5,497,1167,4
4,52,36,16,5,72,60,12,5,497,1167,4
5,54,36,18,5,75,58,17,5,497,1167,4
6,65,42,23,5,78,62,16,5,497,1167,4
7,54,33,21,5,72,54,18,5,497,1167,4
8,48,30,18,5,57,43,14,5,497,1167,4
9,59,33,26,5,72,55,17,5,497,1167,4
10,54,34,20,5,76,56,20,5,497,1167,4
1,57,38,19,5,71,54,17,5,469,517,4
2,66,40,26,5,75,60,15,5,469,517,4
3,57,37,20,5,68,56,12,5,469,517,4
4,42,34,8,5,73,59,14,5,469,517,4
5,47,31,16,5,72,61,11,5,469,517,4
6,54,38,16,5,66,53,13,5,469,517,4
7,55,34,21,5,82,60,22,5,469,517,4
8,57,33,24,5,79,60,19,5,469,517,4
9,54,33,21,5,79,60,19,5,469,517,4
10,64,36,28,5,86,65,21,5,469,517,4
1,98,79,19,5,90,75,15,5,73,1596,4
2,101,85,16,5,94,78,16,5,73,1596,4
3,119,100,19,5,92,76,16,5,73,1596,4
4,119,98,21,5,96,77,19,5,73,1596,4
5,121,96,25,5,92,77,15,5,73,1596,4
6,113,95,18,5,89,74,15,5,73,1596,4
7,89,73,16,5,89,75,14,5,73,1596,4
8,105,82,23,5,97,75,22,5,73,1596,4
9,99,86,13,5,94,78,16,5,73,1596,4
10,114,94,20,5,91,77,14,5,73,1596,4
1,57,43,14,5,74,58,16,5,294,1797,4
2,56,45,11,5,81,63,18,5,294,1797,4
3,73,45,28,5,73,57,16,5,294,1797,4
4,73,46,27,5,91,70,21,5,294,1797,4
5,64,40,24,5,74,59,15,5,294,1797,4
6,64,41,23,5,71,59,12,5,294,1797,4
7,56,37,19,5,63,50,13,5,294,1797,4
8,58,41,17,5,70,51,19,5,294,1797,4
9,50,35,15,5,64,53,11,5,294,1797,4
10,64,45,19,5,80,58,22,5,294,1797,4
1,61,42,19,5,87,66,21,5,412,2989,4
2,54,34,20,5,77,63,14,5,412,2989,4
3,59,39,20,5,72,59,13,5,412,2989,4
4,52,36,16,5,72,60,12,5,412,2989,4
5,54,36,18,5,75,58,17,5,412,2989,4
6,65,42,23,5,78,62,16,5,412,2989,4
7,54,33,21,5,72,54,18,5,412,2989,4
8,48,30,18,5,57,43,14,5,412,2989,4
9,59,33,26,5,72,55,17,5,412,2989,4
10,54,34,20,5,76,56,20,5,412,2989,4
1,98,79,19,5,90,75,15,5,167,369,4
2,101,85,16,5,94,78,16,5,167,369,4
3,119,100,19,5,92,76,16,5,167,369,4
4,119,98,21,5,96,77,19,5,167,369,4
5,121,96,25,5,92,77,15,5,167,369,4
6,113,95,18,5,89,74,15,5,167,369,4
7,89,73,16,5,89,75,14,5,167,369,4
8,105,82,23,5,97,75,22,5,167,369,4
9,99,86,13,5,94,78,16,5,167,369,4
10,114,94,20,5,91,77,14,5,167,369,4
1,60,37,23,5,91,73,18,5,477,2262,4
2,66,40,26,5,92,69,23,5,477,2262,4
3,77,43,34,5,90,64,26,5,477,2262,4
4,64,39,25,5,86,61,25,5,477,2262,4
5,62,36,26,5,84,60,24,5,477,2262,4
6,76,48,28,5,73,49,24,5,477,2262,4
7,73,43,30,5,77,56,21,5,477,2262,4
8,66,45,21,5,93,70,23,5,477,2262,4
9,65,39,26,5,91,72,19,5,477,2262,4
10,59,33,26,5,93,71,22,5,477,2262,4
1,101,82,19,5,92,75,17,5,228,788,4
2,109,89,20,5,93,74,19,5,228,788,4
3,115,97,18,5,94,74,20,5,228,788,4
4,124,106,18,5,93,79,14,5,228,788,4
5,119,91,28,5,92,76,16,5,228,788,4
6,110,94,16,5,91,78,13,5,228,788,4
7,88,72,16,5,91,75,16,5,228,788,4
8,84,68,16,5,95,79,16,5,228,788,4
9,107,90,17,5,89,76,13,5,228,788,4
10,115,93,22,5,94,76,18,5,228,788,4
1,96,71,25,5,100,82,18,5,101,44,4
2,94,70,24,5,104,80,24,5,101,44,4
3,94,70,24,5,101,80,21,5,101,44,4
4,95,69,26,5,102,81,21,5,101,44,4
5,94,68,26,5,105,84,21,5,101,44,4
6,98,68,30,5,104,82,22,5,101,44,4
7,96,69,27,5,98,81,17,5,101,44,4
8,95,66,29,5,102,83,19,5,101,44,4
9,99,71,28,5,100,87,13,5,101,44,4
10,100,69,31,5,98,84,14,5,101,44,4
1,98,79,19,5,90,75,15,5,167,2804,4
2,101,85,16,5,94,78,16,5,167,2804,4
3,119,100,19,5,92,76,16,5,167,2804,4
4,119,98,21,5,96,77,19,5,167,2804,4
5,121,96,25,5,92,77,15,5,167,2804,4
6,113,95,18,5,89,74,15,5,167,2804,4
7,89,73,16,5,89,75,14,5,167,2804,4
8,105,82,23,5,97,75,22,5,167,2804,4
9,99,86,13,5,94,78,16,5,167,2804,4
10,114,94,20,5,91,77,14,5,167,2804,4
1,57,40,17,5,74,55,19,5,292,2120,4
2,68,43,25,5,77,61,16,5,292,2120,4
3,63,45,18,5,80,59,21,5,292,2120,4
4,57,44,13,5,59,44,15,5,292,2120,4
5,68,47,21,5,69,54,15,5,292,2120,4
6,72,47,25,5,83,64,19,5,292,2120,4
7,68,44,24,5,87,65,22,5,292,2120,4
8,62,43,19,5,81,65,16,5,292,2120,4
9,59,41,18,5,58,49,9,5,292,2120,4
10,52,31,21,5,66,56,10,5,292,2120,4
1,54,43,11,5,94,74,20,5,367,1525,4
2,67,49,18,5,74,61,13,5,367,1525,4
3,80,50,30,5,88,67,21,5,367,1525,4
4,73,46,27,5,85,68,17,5,367,1525,4
5,48,35,13,5,58,44,14,5,367,1525,4
6,56,37,19,5,61,46,15,5,367,1525,4
7,52,35,17,5,65,52,13,5,367,1525,4
8,54,40,14,5,69,54,15,5,367,1525,4
9,62,38,24,5,71,48,23,5,367,1525,4
10,64,42,22,5,64,53,11,5,367,1525,4
1,56,36,20,5,78,62,16,5,460,19,4
2,56,38,18,5,67,54,13,5,460,19,4
3,53,38,15,5,79,61,18,5,460,19,4
4,51,34,17,5,75,59,16,5,460,19,4
5,56,34,22,5,69,54,15,5,460,19,4
6,55,38,17,5,72,56,16,5,460,19,4
7,52,34,18,5,74,59,15,5,460,19,4
8,59,33,26,5,74,54,20,5,460,19,4
9,56,31,25,5,63,51,12,5,460,19,4
10,57,34,23,5,79,58,21,5,460,19,4
1,98,79,19,5,90,75,15,5,248,3769,4
2,101,85,16,5,94,78,16,5,248,3769,4
3,119,100,19,5,92,76,16,5,248,3769,4
4,119,98,21,5,96,77,19,5,248,3769,4
5,121,96,25,5,92,77,15,5,248,3769,4
6,113,95,18,5,89,74,15,5,248,3769,4
7,89,73,16,5,89,75,14,5,248,3769,4
8,105,82,23,5,97,75,22,5,248,3769,4
9,99,86,13,5,94,78,16,5,248,3769,4
10,114,94,20,5,91,77,14,5,248,3769,4
1,98,79,19,5,90,75,15,5,155,996,4
2,101,85,16,5,94,78,16,5,155,996,4
3,119,100,19,5,92,76,16,5,155,996,4
4,119,98,21,5,96,77,19,5,155,996,4
5,121,96,25,5,92,77,15,5,155,996,4
6,113,95,18,5,89,74,15,5,155,996,4
7,89,73,16,5,89,75,14,5,155,996,4
8,105,82,23,5,97,75,22,5,155,996,4
9,99,86,13,5,94,78,16,5,155,996,4
10,114,94,20,5,91,77,14,5,155,996,4
1,63,43,20,5,83,62,21,5,320,1057,4
2,68,44,24,5,84,70,14,5,320,1057,4
3,60,39,21,5,78,63,15,5,320,1057,4
4,52,37,15,5,74,57,17,5,320,1057,4
5,53,37,16,5,76,62,14,5,320,1057,4
6,62,43,19,5,78,62,16,5,320,1057,4
7,62,38,24,5,84,64,20,5,320,1057,4
8,61,41,20,5,55,44,11,5,320,1057,4
9,64,45,19,5,66,49,17,5,320,1057,4
10,54,38,16,5,72,55,17,5,320,1057,4
1,98,79,19,5,90,75,15,5,176,350,4
2,101,85,16,5,94,78,16,5,176,350,4
3,119,100,19,5,92,76,16,5,176,350,4
4,119,98,21,5,96,77,19,5,176,350,4
5,121,96,25,5,92,77,15,5,176,350,4
6,113,95,18,5,89,74,15,5,176,350,4
7,89,73,16,5,89,75,14,5,176,350,4
8,105,82,23,5,97,75,22,5,176,350,4
9,99,86,13,5,94,78,16,5,176,350,4
10,114,94,20,5,91,77,14,5,176,350,4
1,98,79,19,5,90,75,15,5,21,715,4
2,101,85,16,5,94,78,16,5,21,715,4
3,119,100,19,5,92,76,16,5,21,715,4
4,119,98,21,5,96,77,19,5,21,715,4
5,121,96,25,5,92,77,15,5,21,715,4
6,113,95,18,5,89,74,15,5,21,715,4
7,89,73,16,5,89,75,14,5,21,715,4
8,105,82,23,5,97,75,22,5,21,715,4
9,99,86,13,5,94,78,16,5,21,715,4
10,114,94,20,5,91,77,14,5,21,715,4
1,98,79,19,5,90,75,15,5,206,2320,4
2,101,85,16,5,94,78,16,5,206,2320,4
3,119,100,19,5,92,76,16,5,206,2320,4
4,119,98,21,5,96,77,19,5,206,2320,4
5,121,96,25,5,92,77,15,5,206,2320,4
6,113,95,18,5,89,74,15,5,206,2320,4
7,89,73,16,5,89,75,14,5,206,2320,4
8,105,82,23,5,97,75,22,5,206,2320,4
9,99,86,13,5,94,78,16,5,206,2320,4
10,114,94,20,5,91,77,14,5,206,2320,4
1,98,79,19,5,90,75,15,5,68,2090,4
2,101,85,16,5,94,78,16,5,68,2090,4
3,119,100,19,5,92,76,16,5,68,2090,4
4,119,98,21,5,96,77,19,5,68,2090,4
5,121,96,25,5,92,77,15,5,68,2090,4
6,113,95,18,5,89,74,15,5,68,2090,4
7,89,73,16,5,89,75,14,5,68,2090,4
8,105,82,23,5,97,75,22,5,68,2090,4
9,99,86,13,5,94,78,16,5,68,2090,4
10,114,94,20,5,91,77,14,5,68,2090,4
1,91,79,12,5,89,74,15,5,221,1725,4
2,120,96,24,5,93,77,16,5,221,1725,4
3,121,104,17,5,93,75,18,5,221,1725,4
4,130,107,23,5,101,78,23,5,221,1725,4
5,117,92,25,5,93,73,20,5,221,1725,4
6,110,92,18,5,89,75,14,5,221,1725,4
7,90,72,18,5,87,74,13,5,221,1725,4
8,89,72,17,5,93,77,16,5,221,1725,4
9,104,85,19,5,88,77,11,5,221,1725,4
10,110,93,17,5,92,76,16,5,221,1725,4
1,98,79,19,5,90,75,15,5,195,460,4
2,101,85,16,5,94,78,16,5,195,460,4
3,119,100,19,5,92,76,16,5,195,460,4
4,119,98,21,5,96,77,19,5,195,460,4
5,121,96,25,5,92,77,15,5,195,460,4
6,113,95,18,5,89,74,15,5,195,460,4
7,89,73,16,5,89,75,14,5,195,460,4
8,105,82,23,5,97,75,22,5,195,460,4
9,99,86,13,5,94,78,16,5,195,460,4
10,114,94,20,5,91,77,14,5,195,460,4
1,63,45,18,5,83,64,19,5,296,3282,4
2,62,44,18,5,61,51,10,5,296,3282,4
3,73,50,23,5,75,61,14,5,296,3282,4
4,66,44,22,5,86,63,23,5,296,3282,4
5,64,38,26,5,81,64,17,5,296,3282,4
6,55,37,18,5,86,69,17,5,296,3282,4
7,56,38,18,5,57,46,11,5,296,3282,4
8,53,35,18,5,72,56,16,5,296,3282,4
9,54,38,16,5,57,49,8,5,296,3282,4
10,63,40,23,5,88,60,28,5,296,3282,4
1,98,79,19,5,90,75,15,5,171,3306,4
2,101,85,16,5,94,78,16,5,171,3306,4
3,119,100,19,5,92,76,16,5,171,3306,4
4,119,98,21,5,96,77,19,5,171,3306,4
5,121,96,25,5,92,77,15,5,171,3306,4
6,113,95,18,5,89,74,15,5,171,3306,4
7,89,73,16,5,89,75,14,5,171,3306,4
8,105,82,23,5,97,75,22,5,171,3306,4
9,99,86,13,5,94,78,16,5,171,3306,4
10,114,94,20,5,91,77,14,5,171,3306,4
1,98,79,19,5,90,75,15,5,117,1322,4
2,101,85,16,5,94,78,16,5,117,1322,4
3,119,100,19,5,92,76,16,5,117,1322,4
4,119,98,21,5,96,77,19,5,117,1322,4
5,121,96,25,5,92,77,15,5,117,1322,4
6,113,95,18,5,89,74,15,5,117,1322,4
7,89,73,16,5,89,75,14,5,117,1322,4
8,105,82,23,5,97,75,22,5,117,1322,4
9,99,86,13,5,94,78,16,5,117,1322,4
10,114,94,20,5,91,77,14,5,117,1322,4
1,99,70,29,5,105,86,19,5,245,1273,4
2,96,69,27,5,105,83,22,5,245,1273,4
3,95,70,25,5,103,86,17,5,245,1273,4
4,95,68,27,5,100,85,15,5,245,1273,4
5,97,71,26,5,103,83,20,5,245,1273,4
6,95,72,23,5,107,79,28,5,245,1273,4
7,102,74,28,5,102,83,19,5,245,1273,4
8,97,69,28,5,104,85,19,5,245,1273,4
9,101,71,30,5,98,83,15,5,245,1273,4
10,90,71,19,5,96,82,14,5,245,1273,4
1,60,46,14,5,59,50,9,5,291,3001,4
2,63,45,18,5,58,48,10,5,291,3001,4
3,79,51,28,5,93,72,21,5,291,3001,4
4,67,47,20,5,92,68,24,5,291,3001,4
5,51,35,16,5,81,61,20,5,291,3001,4
6,66,43,23,5,69,57,12,5,291,3001,4
7,77,50,27,5,84,64,20,5,291,3001,4
8,51,33,18,5,84,66,18,5,291,3001,4
9,51,37,14,5,57,44,13,5,291,3001,4
10,61,39,22,5,70,54,16,5,291,3001,4
1,91,79,12,5,89,74,15,5,134,3261,4
2,120,96,24,5,93,77,16,5,134,3261,4
3,121,104,17,5,93,75,18,5,134,3261,4
4,130,107,23,5,101,78,23,5,134,3261,4
5,117,92,25,5,93,73,20,5,134,3261,4
6,110,92,18,5,89,75,14,5,134,3261,4
7,90,72,18,5,87,74,13,5,134,3261,4
8,89,72,17,5,93,77,16,5,134,3261,4
9,104,85,19,5,88,77,11,5,134,3261,4
10,110,93,17,5,92,76,16,5,134,3261,4
1,98,79,19,5,90,75,15,5,132,3579,4
2,101,85,16,5,94,78,16,5,132,3579,4
3,119,100,19,5,92,76,16,5,132,3579,4
4,119,98,21,5,96,77,19,5,132,3579,4
5,121,96,25,5,92,77,15,5,132,3579,4
6,113,95,18,5,89,74,15,5,132,3579,4
7,89,73,16,5,89,75,14,5,132,3579,4
8,105,82,23,5,97,75,22,5,132,3579,4
9,99,86,13,5,94,78,16,5,132,3579,4
10,114,94,20,5,91,77,14,5,132,3579,4
1,98,79,19,5,90,75,15,5,37,2543,4
2,101,85,16,5,94,78,16,5,37,2543,4
3,119,100,19,5,92,76,16,5,37,2543,4
4,119,98,21,5,96,77,19,5,37,2543,4
5,121,96,25,5,92,77,15,5,37,2543,4
6,113,95,18,5,89,74,15,5,37,2543,4
7,89,73,16,5,89,75,14,5,37,2543,4
8,105,82,23,5,97,75,22,5,37,2543,4
9,99,86,13,5,94,78,16,5,37,2543,4
10,114,94,20,5,91,77,14,5,37,2543,4
1,59,38,21,5,74,53,21,5,494,937,4
2,64,40,24,5,93,72,21,5,494,937,4
3,57,38,19,5,69,60,9,5,494,937,4
4,56,37,19,5,71,58,13,5,494,937,4
5,60,37,23,5,68,56,12,5,494,937,4
6,52,34,18,5,81,60,21,5,494,937,4
7,59,32,27,5,80,61,19,5,494,937,4
8,42,28,14,5,69,54,15,5,494,937,4
9,51,32,19,5,71,53,18,5,494,937,4
10,49,33,16,5,70,56,14,5,494,937,4
1,61,45,16,5,90,69,21,5,387,2193,4
2,73,54,19,5,58,46,12,5,387,2193,4
3,80,52,28,5,72,60,12,5,387,2193,4
4,81,53,28,5,92,72,20,5,387,2193,4
5,54,38,16,5,80,63,17,5,387,2193,4
6,54,38,16,5,54,43,11,5,387,2193,4
7,55,37,18,5,69,55,14,5,387,2193,4
8,56,39,17,5,80,63,17,5,387,2193,4
9,52,36,16,5,62,46,16,5,387,2193,4
10,67,42,25,5,69,47,22,5,387,2193,4
1,98,79,19,5,90,75,15,5,96,240,4
2,101,85,16,5,94,78,16,5,96,240,4
3,119,100,19,5,92,76,16,5,96,240,4
4,119,98,21,5,96,77,19,5,96,240,4
5,121,96,25,5,92,77,15,5,96,240,4
6,113,95,18,5,89,74,15,5,96,240,4
7,89,73,16,5,89,75,14,5,96,240,4
8,105,82,23,5,97,75,22,5,96,240,4
9,99,86,13,5,94,78,16,5,96,240,4
10,114,94,20,5,91,77,14,5,96,240,4
1,98,79,19,5,90,75,15,5,213,1987,4
2,101,85,16,5,94,78,16,5,213,1987,4
3,119,100,19,5,92,76,16,5,213,1987,4
4,119,98,21,5,96,77,19,5,213,1987,4
5,121,96,25,5,92,77,15,5,213,1987,4
6,113,95,18,5,89,74,15,5,213,1987,4
7,89,73,16,5,89,75,14,5,213,1987,4
8,105,82,23,5,97,75,22,5,213,1987,4
9,99,86,13,5,94,78,16,5,213,1987,4
10,114,94,20,5,91,77,14,5,213,1987,4
1,50,39,11,5,75,60,15,5,362,943,4
2,70,49,21,5,82,64,18,5,362,943,4
3,69,45,24,5,78,63,15,5,362,943,4
4,80,55,25,5,89,70,19,5,362,943,4
5,59,37,22,5,61,49,12,5,362,943,4
6,63,40,23,5,75,59,16,5,362,943,4
7,65,46,19,5,79,62,17,5,362,943,4
8,58,41,17,5,65,55,10,5,362,943,4
9,64,40,24,5,72,51,21,5,362,943,4
10,64,44,20,5,74,54,20,5,362,943,4
1,67,50,17,5,61,49,12,5,299,1985,4
2,72,49,23,5,80,61,19,5,299,1985,4
3,66,46,20,5,74,59,15,5,299,1985,4
4,72,50,22,5,69,56,13,5,299,1985,4
5,48,37,11,5,78,55,23,5,299,1985,4
6,74,42,32,5,83,67,16,5,299,1985,4
7,61,42,19,5,75,58,17,5,299,1985,4
8,57,39,18,5,82,68,14,5,299,1985,4
9,53,37,16,5,63,48,15,5,299,1985,4
10,59,39,20,5,66,48,18,5,299,1985,4
1,57,34,23,5,91,73,18,5,470,1598,4
2,66,36,30,5,101,78,23,5,470,1598,4
3,65,36,29,5,70,51,19,5,470,1598,4
4,53,35,18,5,104,73,31,5,470,1598,4
5,67,37,30,5,84,59,25,5,470,1598,4
6,70,45,25,5,88,64,24,5,470,1598,4
7,65,36,29,5,72,52,20,5,470,1598,4
8,58,39,19,5,100,76,24,5,470,1598,4
9,64,40,24,5,92,68,24,5,470,1598,4
10,83,47,36,5,87,70,17,5,470,1598,4
1,54,42,12,5,78,62,16,5,384,3744,4
2,63,45,18,5,69,57,12,5,384,3744,4
3,66,43,23,5,73,59,14,5,384,3744,4
4,65,43,22,5,98,75,23,5,384,3744,4
5,67,43,24,5,75,60,15,5,384,3744,4
6,60,37,23,5,73,58,15,5,384,3744,4
7,47,34,13,5,62,47,15,5,384,3744,4
8,56,38,18,5,60,46,14,5,384,3744,4
9,56,39,17,5,79,60,19,5,384,3744,4
10,86,57,29,5,69,49,20,5,384,3744,4
1,65,42,23,5,88,70,18,5,435,664,4
2,66,42,24,5,77,64,13,5,435,664,4
3,51,36,15,5,78,62,16,5,435,664,4
4,48,34,14,5,80,63,17,5,435,664,4
5,52,33,19,5,54,43,11,5,435,664,4
6,50,37,13,5,66,48,18,5,435,664,4
7,54,33,21,5,60,47,13,5,435,664,4
8,48,31,17,5,64,49,15,5,435,664,4
9,63,34,29,5,78,61,17,5,435,664,4
10,59,33,26,5,93,67,26,5,435,664,4
1,98,79,19,5,90,75,15,5,225,3777,4
2,101,85,16,5,94,78,16,5,225,3777,4
3,119,100,19,5,92,76,16,5,225,3777,4
4,119,98,21,5,96,77,19,5,225,3777,4
5,121,96,25,5,92,77,15,5,225,3777,4
6,113,95,18,5,89,74,15,5,225,3777,4
7,89,73,16,5,89,75,14,5,225,3777,4
8,105,82,23,5,97,75,22,5,225,3777,4
9,99,86,13,5,94,78,16,5,225,3777,4
10,114,94,20,5,91,77,14,5,225,3777,4
1,67,47,20,5,73,56,17,5,357,1524,4
2,74,44,30,5,71,58,13,5,357,1524,4
3,57,41,16,5,71,54,17,5,357,1524,4
4,53,38,15,5,71,55,16,5,357,1524,4
5,64,39,25,5,64,51,13,5,357,1524,4
6,52,35,17,5,86,69,17,5,357,1524,4
7,56,36,20,5,72,56,16,5,357,1524,4
8,50,33,17,5,64,52,12,5,357,1524,4
9,56,32,24,5,75,59,16,5,357,1524,4
10,53,36,17,5,86,61,25,5,357,1524,4
1,98,79,19,5,90,75,15,5,23,2705,4
2,101,85,16,5,94,78,16,5,23,2705,4
3,119,100,19,5,92,76,16,5,23,2705,4
4,119,98,21,5,96,77,19,5,23,2705,4
5,121,96,25,5,92,77,15,5,23,2705,4
6,113,95,18,5,89,74,15,5,23,2705,4
7,89,73,16,5,89,75,14,5,23,2705,4
8,105,82,23,5,97,75,22,5,23,2705,4
9,99,86,13,5,94,78,16,5,23,2705,4
10,114,94,20,5,91,77,14,5,23,2705,4
1,98,79,19,5,90,75,15,5,61,2544,4
2,101,85,16,5,94,78,16,5,61,2544,4
3,119,100,19,5,92,76,16,5,61,2544,4
4,119,98,21,5,96,77,19,5,61,2544,4
5,121,96,25,5,92,77,15,5,61,2544,4
6,113,95,18,5,89,74,15,5,61,2544,4
7,89,73,16,5,89,75,14,5,61,2544,4
8,105,82,23,5,97,75,22,5,61,2544,4
9,99,86,13,5,94,78,16,5,61,2544,4
10,114,94,20,5,91,77,14,5,61,2544,4
1,61,45,16,5,90,69,21,5,387,87,4
2,73,54,19,5,58,46,12,5,387,87,4
3,80,52,28,5,72,60,12,5,387,87,4
4,81,53,28,5,92,72,20,5,387,87,4
5,54,38,16,5,80,63,17,5,387,87,4
6,54,38,16,5,54,43,11,5,387,87,4
7,55,37,18,5,69,55,14,5,387,87,4
8,56,39,17,5,80,63,17,5,387,87,4
9,52,36,16,5,62,46,16,5,387,87,4
10,67,42,25,5,69,47,22,5,387,87,4
1,98,79,19,5,90,75,15,5,219,2162,4
2,101,85,16,5,94,78,16,5,219,2162,4
3,119,100,19,5,92,76,16,5,219,2162,4
4,119,98,21,5,96,77,19,5,219,2162,4
5,121,96,25,5,92,77,15,5,219,2162,4
6,113,95,18,5,89,74,15,5,219,2162,4
7,89,73,16,5,89,75,14,5,219,2162,4
8,105,82,23,5,97,75,22,5,219,2162,4
9,99,86,13,5,94,78,16,5,219,2162,4
10,114,94,20,5,91,77,14,5,219,2162,4
1,98,79,19,5,90,75,15,5,204,3141,4
2,101,85,16,5,94,78,16,5,204,3141,4
3,119,100,19,5,92,76,16,5,204,3141,4
4,119,98,21,5,96,77,19,5,204,3141,4
5,121,96,25,5,92,77,15,5,204,3141,4
6,113,95,18,5,89,74,15,5,204,3141,4
7,89,73,16,5,89,75,14,5,204,3141,4
8,105,82,23,5,97,75,22,5,204,3141,4
9,99,86,13,5,94,78,16,5,204,3141,4
10,114,94,20,5,91,77,14,5,204,3141,4
1,98,79,19,5,90,75,15,5,146,581,4
2,101,85,16,5,94,78,16,5,146,581,4
3,119,100,19,5,92,76,16,5,146,581,4
4,119,98,21,5,96,77,19,5,146,581,4
5,121,96,25,5,92,77,15,5,146,581,4
6,113,95,18,5,89,74,15,5,146,581,4
7,89,73,16,5,89,75,14,5,146,581,4
8,105,82,23,5,97,75,22,5,146,581,4
9,99,86,13,5,94,78,16,5,146,581,4
10,114,94,20,5,91,77,14,5,146,581,4
1,98,79,19,5,90,75,15,5,276,2869,4
2,101,85,16,5,94,78,16,5,276,2869,4
3,119,100,19,5,92,76,16,5,276,2869,4
4,119,98,21,5,96,77,19,5,276,2869,4
5,121,96,25,5,92,77,15,5,276,2869,4
6,113,95,18,5,89,74,15,5,276,2869,4
7,89,73,16,5,89,75,14,5,276,2869,4
8,105,82,23,5,97,75,22,5,276,2869,4
9,99,86,13,5,94,78,16,5,276,2869,4
10,114,94,20,5,91,77,14,5,276,2869,4
1,98,79,19,5,90,75,15,5,203,517,4
2,101,85,16,5,94,78,16,5,203,517,4
3,119,100,19,5,92,76,16,5,203,517,4
4,119,98,21,5,96,77,19,5,203,517,4
5,121,96,25,5,92,77,15,5,203,517,4
6,113,95,18,5,89,74,15,5,203,517,4
7,89,73,16,5,89,75,14,5,203,517,4
8,105,82,23,5,97,75,22,5,203,517,4
9,99,86,13,5,94,78,16,5,203,517,4
10,114,94,20,5,91,77,14,5,203,517,4
1,98,79,19,5,90,75,15,5,11,3113,4
2,101,85,16,5,94,78,16,5,11,3113,4
3,119,100,19,5,92,76,16,5,11,3113,4
4,119,98,21,5,96,77,19,5,11,3113,4
5,121,96,25,5,92,77,15,5,11,3113,4
6,113,95,18,5,89,74,15,5,11,3113,4
7,89,73,16,5,89,75,14,5,11,3113,4
8,105,82,23,5,97,75,22,5,11,3113,4
9,99,86,13,5,94,78,16,5,11,3113,4
10,114,94,20,5,91,77,14,5,11,3113,4
1,98,79,19,5,90,75,15,5,236,2739,4
2,101,85,16,5,94,78,16,5,236,2739,4
3,119,100,19,5,92,76,16,5,236,2739,4
4,119,98,21,5,96,77,19,5,236,2739,4
5,121,96,25,5,92,77,15,5,236,2739,4
6,113,95,18,5,89,74,15,5,236,2739,4
7,89,73,16,5,89,75,14,5,236,2739,4
8,105,82,23,5,97,75,22,5,236,2739,4
9,99,86,13,5,94,78,16,5,236,2739,4
10,114,94,20,5,91,77,14,5,236,2739,4
1,50,35,15,5,69,53,16,5,403,3282,4
2,73,40,33,5,81,62,19,5,403,3282,4
3,55,38,17,5,66,56,10,5,403,3282,4
4,47,34,13,5,73,59,14,5,403,3282,4
5,46,30,16,5,76,62,14,5,403,3282,4
6,60,40,20,5,62,51,11,5,403,3282,4
7,58,34,24,5,82,60,22,5,403,3282,4
8,60,37,23,5,79,61,18,5,403,3282,4
9,54,33,21,5,82,63,19,5,403,3282,4
10,59,35,24,5,82,63,19,5,403,3282,4
1,98,79,19,5,90,75,15,5,49,700,4
2,101,85,16,5,94,78,16,5,49,700,4
3,119,100,19,5,92,76,16,5,49,700,4
4,119,98,21,5,96,77,19,5,49,700,4
5,121,96,25,5,92,77,15,5,49,700,4
6,113,95,18,5,89,74,15,5,49,700,4
7,89,73,16,5,89,75,14,5,49,700,4
8,105,82,23,5,97,75,22,5,49,700,4
9,99,86,13,5,94,78,16,5,49,700,4
10,114,94,20,5,91,77,14,5,49,700,4
1,56,41,15,5,68,58,10,5,350,72,4
2,69,53,16,5,89,69,20,5,350,72,4
3,64,44,20,5,96,79,17,5,350,72,4
4,74,48,26,5,74,62,12,5,350,72,4
5,49,32,17,5,80,58,22,5,350,72,4
6,66,41,25,5,60,45,15,5,350,72,4
7,66,41,25,5,58,43,15,5,350,72,4
8,51,35,16,5,73,55,18,5,350,72,4
9,55,35,20,5,66,49,17,5,350,72,4
10,49,33,16,5,66,48,18,5,350,72,4
1,57,37,20,5,83,61,22,5,453,2844,4
2,52,37,15,5,84,65,19,5,453,2844,4
3,69,42,27,5,72,59,13,5,453,2844,4
4,50,33,17,5,69,55,14,5,453,2844,4
5,59,37,22,5,61,53,8,5,453,2844,4
6,55,36,19,5,83,59,24,5,453,2844,4
7,50,31,19,5,72,57,15,5,453,2844,4
8,52,31,21,5,68,55,13,5,453,2844,4
9,56,33,23,5,67,52,15,5,453,2844,4
10,45,29,16,5,85,64,21,5,453,2844,4
1,92,78,14,5,88,75,13,5,258,2173,4
2,119,96,23,5,93,75,18,5,258,2173,4
3,114,99,15,5,94,74,20,5,258,2173,4
4,118,100,18,5,94,77,17,5,258,2173,4
5,122,97,25,5,94,77,17,5,258,2173,4
6,122,99,23,5,90,72,18,5,258,2173,4
7,104,82,22,5,92,75,17,5,258,2173,4
8,85,69,16,5,93,77,16,5,258,2173,4
9,104,84,20,5,87,77,10,5,258,2173,4
10,109,94,15,5,93,77,16,5,258,2173,4
1,61,45,16,5,90,69,21,5,387,1129,4
2,73,54,19,5,58,46,12,5,387,1129,4
3,80,52,28,5,72,60,12,5,387,1129,4
4,81,53,28,5,92,72,20,5,387,1129,4
5,54,38,16,5,80,63,17,5,387,1129,4
6,54,38,16,5,54,43,11,5,387,1129,4
7,55,37,18,5,69,55,14,5,387,1129,4
8,56,39,17,5,80,63,17,5,387,1129,4
9,52,36,16,5,62,46,16,5,387,1129,4
10,67,42,25,5,69,47,22,5,387,1129,4
1,98,79,19,5,90,75,15,5,104,1694,4
2,101,85,16,5,94,78,16,5,104,1694,4
3,119,100,19,5,92,76,16,5,104,1694,4
4,119,98,21,5,96,77,19,5,104,1694,4
5,121,96,25,5,92,77,15,5,104,1694,4
6,113,95,18,5,89,74,15,5,104,1694,4
7,89,73,16,5,89,75,14,5,104,1694,4
8,105,82,23,5,97,75,22,5,104,1694,4
9,99,86,13,5,94,78,16,5,104,1694,4
10,114,94,20,5,91,77,14,5,104,1694,4
1,98,79,19,5,90,75,15,5,160,1225,4
2,101,85,16,5,94,78,16,5,160,1225,4
3,119,100,19,5,92,76,16,5,160,1225,4
4,119,98,21,5,96,77,19,5,160,1225,4
5,121,96,25,5,92,77,15,5,160,1225,4
6,113,95,18,5,89,74,15,5,160,1225,4
7,89,73,16,5,89,75,14,5,160,1225,4
8,105,82,23,5,97,75,22,5,160,1225,4
9,99,86,13,5,94,78,16,5,160,1225,4
10,114,94,20,5,91,77,14,5,160,1225,4
1,99,70,29,5,105,86,19,5,245,3350,4
2,96,69,27,5,105,83,22,5,245,3350,4
3,95,70,25,5,103,86,17,5,245,3350,4
4,95,68,27,5,100,85,15,5,245,3350,4
5,97,71,26,5,103,83,20,5,245,3350,4
6,95,72,23,5,107,79,28,5,245,3350,4
7,102,74,28,5,102,83,19,5,245,3350,4
8,97,69,28,5,104,85,19,5,245,3350,4
9,101,71,30,5,98,83,15,5,245,3350,4
10,90,71,19,5,96,82,14,5,245,3350,4
1,98,79,19,5,90,75,15,5,105,5,4
2,101,85,16,5,94,78,16,5,105,5,4
3,119,100,19,5,92,76,16,5,105,5,4
4,119,98,21,5,96,77,19,5,105,5,4
5,121,96,25,5,92,77,15,5,105,5,4
6,113,95,18,5,89,74,15,5,105,5,4
7,89,73,16,5,89,75,14,5,105,5,4
8,105,82,23,5,97,75,22,5,105,5,4
9,99,86,13,5,94,78,16,5,105,5,4
10,114,94,20,5,91,77,14,5,105,5,4
1,98,79,19,5,90,75,15,5,208,1184,4
2,101,85,16,5,94,78,16,5,208,1184,4
3,119,100,19,5,92,76,16,5,208,1184,4
4,119,98,21,5,96,77,19,5,208,1184,4
5,121,96,25,5,92,77,15,5,208,1184,4
6,113,95,18,5,89,74,15,5,208,1184,4
7,89,73,16,5,89,75,14,5,208,1184,4
8,105,82,23,5,97,75,22,5,208,1184,4
9,99,86,13,5,94,78,16,5,208,1184,4
10,114,94,20,5,91,77,14,5,208,1184,4
1,98,79,19,5,90,75,15,5,156,2847,4
2,101,85,16,5,94,78,16,5,156,2847,4
3,119,100,19,5,92,76,16,5,156,2847,4
4,119,98,21,5,96,77,19,5,156,2847,4
5,121,96,25,5,92,77,15,5,156,2847,4
6,113,95,18,5,89,74,15,5,156,2847,4
7,89,73,16,5,89,75,14,5,156,2847,4
8,105,82,23,5,97,75,22,5,156,2847,4
9,99,86,13,5,94,78,16,5,156,2847,4
10,114,94,20,5,91,77,14,5,156,2847,4
1,91,79,12,5,89,75,14,5,109,2767,4
2,119,96,23,5,94,78,16,5,109,2767,4
3,121,104,17,5,94,74,20,5,109,2767,4
4,132,107,25,5,100,77,23,5,109,2767,4
5,120,92,28,5,93,75,18,5,109,2767,4
6,110,92,18,5,91,78,13,5,109,2767,4
7,91,72,19,5,86,73,13,5,109,2767,4
8,87,72,15,5,94,78,16,5,109,2767,4
9,101,85,16,5,89,77,12,5,109,2767,4
10,111,93,18,5,94,77,17,5,109,2767,4
1,98,79,19,5,90,75,15,5,84,3167,4
2,101,85,16,5,94,78,16,5,84,3167,4
3,119,100,19,5,92,76,16,5,84,3167,4
4,119,98,21,5,96,77,19,5,84,3167,4
5,121,96,25,5,92,77,15,5,84,3167,4
6,113,95,18,5,89,74,15,5,84,3167,4
7,89,73,16,5,89,75,14,5,84,3167,4
8,105,82,23,5,97,75,22,5,84,3167,4
9,99,86,13,5,94,78,16,5,84,3167,4
10,114,94,20,5,91,77,14,5,84,3167,4
1,98,79,19,5,90,75,15,5,40,3115,4
2,101,85,16,5,94,78,16,5,40,3115,4
3,119,100,19,5,92,76,16,5,40,3115,4
4,119,98,21,5,96,77,19,5,40,3115,4
5,121,96,25,5,92,77,15,5,40,3115,4
6,113,95,18,5,89,74,15,5,40,3115,4
7,89,73,16,5,89,75,14,5,40,3115,4
8,105,82,23,5,97,75,22,5,40,3115,4
9,99,86,13,5,94,78,16,5,40,3115,4
10,114,94,20,5,91,77,14,5,40,3115,4
1,79,68,11,5,92,79,13,5,283,3125,4
2,113,89,24,5,94,76,18,5,283,3125,4
3,106,82,24,5,95,75,20,5,283,3125,4
4,125,102,23,5,91,76,15,5,283,3125,4
5,101,78,23,5,94,77,17,5,283,3125,4
6,102,83,19,5,89,73,16,5,283,3125,4
7,103,88,15,5,91,76,15,5,283,3125,4
8,110,92,18,5,93,76,17,5,283,3125,4
9,119,99,20,5,91,75,16,5,283,3125,4
10,107,94,13,5,94,79,15,5,283,3125,4
1,95,73,22,5,105,84,21,5,244,1925,4
2,94,73,21,5,103,85,18,5,244,1925,4
3,94,74,20,5,102,85,17,5,244,1925,4
4,104,75,29,5,99,86,13,5,244,1925,4
5,99,71,28,5,99,83,16,5,244,1925,4
6,98,67,31,5,100,80,20,5,244,1925,4
7,104,72,32,5,104,84,20,5,244,1925,4
8,96,67,29,5,103,85,18,5,244,1925,4
9,105,75,30,5,102,78,24,5,244,1925,4
10,93,73,20,5,100,77,23,5,244,1925,4
1,98,79,19,5,90,75,15,5,138,1185,4
2,101,85,16,5,94,78,16,5,138,1185,4
3,119,100,19,5,92,76,16,5,138,1185,4
4,119,98,21,5,96,77,19,5,138,1185,4
5,121,96,25,5,92,77,15,5,138,1185,4
6,113,95,18,5,89,74,15,5,138,1185,4
7,89,73,16,5,89,75,14,5,138,1185,4
8,105,82,23,5,97,75,22,5,138,1185,4
9,99,86,13,5,94,78,16,5,138,1185,4
10,114,94,20,5,91,77,14,5,138,1185,4
1,58,41,17,5,82,65,17,5,297,842,4
2,71,49,22,5,92,65,27,5,297,842,4
3,70,47,23,5,54,44,10,5,297,842,4
4,77,50,27,5,71,60,11,5,297,842,4
5,55,36,19,5,75,55,20,5,297,842,4
6,69,46,23,5,77,62,15,5,297,842,4
7,56,39,17,5,61,50,11,5,297,842,4
8,45,32,13,5,81,65,16,5,297,842,4
9,55,36,19,5,70,56,14,5,297,842,4
10,54,36,18,5,80,59,21,5,297,842,4
1,91,79,12,5,89,74,15,5,123,1969,4
2,120,96,24,5,93,77,16,5,123,1969,4
3,121,104,17,5,93,75,18,5,123,1969,4
4,130,107,23,5,101,78,23,5,123,1969,4
5,117,92,25,5,93,73,20,5,123,1969,4
6,110,92,18,5,89,75,14,5,123,1969,4
7,90,72,18,5,87,74,13,5,123,1969,4
8,89,72,17,5,93,77,16,5,123,1969,4
9,104,85,19,5,88,77,11,5,123,1969,4
10,110,93,17,5,92,76,16,5,123,1969,4
1,63,41,22,5,91,70,21,5,355,3784,4
2,60,39,21,5,88,71,17,5,355,3784,4
3,58,41,17,5,66,53,13,5,355,3784,4
4,72,45,27,5,76,56,20,5,355,3784,4
5,49,32,17,5,56,42,14,5,355,3784,4
6,68,45,23,5,73,52,21,5,355,3784,4
7,49,34,15,5,80,62,18,5,355,3784,4
8,63,41,22,5,64,53,11,5,355,3784,4
9,68,41,27,5,74,59,15,5,355,3784,4
10,49,35,14,5,68,55,13,5,355,3784,4
1,98,79,19,5,90,75,15,5,178,1738,4
2,101,85,16,5,94,78,16,5,178,1738,4
3,119,100,19,5,92,76,16,5,178,1738,4
4,119,98,21,5,96,77,19,5,178,1738,4
5,121,96,25,5,92,77,15,5,178,1738,4
6,113,95,18,5,89,74,15,5,178,1738,4
7,89,73,16,5,89,75,14,5,178,1738,4
8,105,82,23,5,97,75,22,5,178,1738,4
9,99,86,13,5,94,78,16,5,178,1738,4
10,114,94,20,5,91,77,14,5,178,1738,4
1,98,79,19,5,90,75,15,5,28,1812,4
2,101,85,16,5,94,78,16,5,28,1812,4
3,119,100,19,5,92,76,16,5,28,1812,4
4,119,98,21,5,96,77,19,5,28,1812,4
5,121,96,25,5,92,77,15,5,28,1812,4
6,113,95,18,5,89,74,15,5,28,1812,4
7,89,73,16,5,89,75,14,5,28,1812,4
8,105,82,23,5,97,75,22,5,28,1812,4
9,99,86,13,5,94,78,16,5,28,1812,4
10,114,94,20,5,91,77,14,5,28,1812,4
1,98,79,19,5,90,75,15,5,121,1636,4
2,101,85,16,5,94,78,16,5,121,1636,4
3,119,100,19,5,92,76,16,5,121,1636,4
4,119,98,21,5,96,77,19,5,121,1636,4
5,121,96,25,5,92,77,15,5,121,1636,4
6,113,95,18,5,89,74,15,5,121,1636,4
7,89,73,16,5,89,75,14,5,121,1636,4
8,105,82,23,5,97,75,22,5,121,1636,4
9,99,86,13,5,94,78,16,5,121,1636,4
10,114,94,20,5,91,77,14,5,121,1636,4
1,98,79,19,5,90,75,15,5,21,736,4
2,101,85,16,5,94,78,16,5,21,736,4
3,119,100,19,5,92,76,16,5,21,736,4
4,119,98,21,5,96,77,19,5,21,736,4
5,121,96,25,5,92,77,15,5,21,736,4
6,113,95,18,5,89,74,15,5,21,736,4
7,89,73,16,5,89,75,14,5,21,736,4
8,105,82,23,5,97,75,22,5,21,736,4
9,99,86,13,5,94,78,16,5,21,736,4
10,114,94,20,5,91,77,14,5,21,736,4
1,67,45,22,5,82,61,21,5,305,227,4
2,65,46,19,5,71,59,12,5,305,227,4
3,65,44,21,5,78,61,17,5,305,227,4
4,73,49,24,5,83,66,17,5,305,227,4
5,60,36,24,5,76,58,18,5,305,227,4
6,58,39,19,5,60,50,10,5,305,227,4
7,57,37,20,5,80,61,19,5,305,227,4
8,70,46,24,5,69,56,13,5,305,227,4
9,49,33,16,5,70,53,17,5,305,227,4
10,52,35,17,5,67,49,18,5,305,227,4
1,68,48,20,5,65,54,11,5,397,2604,4
2,60,47,13,5,74,58,16,5,397,2604,4
3,67,44,23,5,82,64,18,5,397,2604,4
4,73,46,27,5,89,69,20,5,397,2604,4
5,49,32,17,5,78,64,14,5,397,2604,4
6,51,35,16,5,63,47,16,5,397,2604,4
7,54,36,18,5,72,54,18,5,397,2604,4
8,67,42,25,5,64,50,14,5,397,2604,4
9,54,36,18,5,62,48,14,5,397,2604,4
10,61,39,22,5,73,52,21,5,397,2604,4
1,64,45,19,5,83,64,19,5,370,2375,4
2,55,42,13,5,85,68,17,5,370,2375,4
3,73,47,26,5,67,55,12,5,370,2375,4
4,63,45,18,5,81,64,17,5,370,2375,4
5,61,40,21,5,72,55,17,5,370,2375,4
6,64,41,23,5,57,44,13,5,370,2375,4
7,59,38,21,5,73,58,15,5,370,2375,4
8,66,46,20,5,77,62,15,5,370,2375,4
9,53,36,17,5,66,52,14,5,370,2375,4
10,61,38,23,5,81,58,23,5,370,2375,4
1,50,35,15,5,74,58,16,5,498,2820,4
2,61,38,23,5,83,66,17,5,498,2820,4
3,66,42,24,5,82,64,18,5,498,2820,4
4,47,32,15,5,82,68,14,5,498,2820,4
5,61,38,23,5,68,53,15,5,498,2820,4
6,61,40,21,5,75,54,21,5,498,2820,4
7,59,35,24,5,72,53,19,5,498,2820,4
8,44,29,15,5,64,51,13,5,498,2820,4
9,61,36,25,5,55,43,12,5,498,2820,4
10,46,31,15,5,73,56,17,5,498,2820,4
1,98,79,19,5,90,75,15,5,39,613,4
2,101,85,16,5,94,78,16,5,39,613,4
3,119,100,19,5,92,76,16,5,39,613,4
4,119,98,21,5,96,77,19,5,39,613,4
5,121,96,25,5,92,77,15,5,39,613,4
6,113,95,18,5,89,74,15,5,39,613,4
7,89,73,16,5,89,75,14,5,39,613,4
8,105,82,23,5,97,75,22,5,39,613,4
9,99,86,13,5,94,78,16,5,39,613,4
10,114,94,20,5,91,77,14,5,39,613,4
1,95,73,22,5,105,84,21,5,243,2199,4
2,94,73,21,5,103,85,18,5,243,2199,4
3,94,74,20,5,102,85,17,5,243,2199,4
4,104,75,29,5,99,86,13,5,243,2199,4
5,99,71,28,5,99,83,16,5,243,2199,4
6,98,67,31,5,100,80,20,5,243,2199,4
7,104,72,32,5,104,84,20,5,243,2199,4
8,96,67,29,5,103,85,18,5,243,2199,4
9,105,75,30,5,102,78,24,5,243,2199,4
10,93,73,20,5,100,77,23,5,243,2199,4
1,98,79,19,5,90,75,15,5,166,1267,4
2,101,85,16,5,94,78,16,5,166,1267,4
3,119,100,19,5,92,76,16,5,166,1267,4
4,119,98,21,5,96,77,19,5,166,1267,4
5,121,96,25,5,92,77,15,5,166,1267,4
6,113,95,18,5,89,74,15,5,166,1267,4
7,89,73,16,5,89,75,14,5,166,1267,4
8,105,82,23,5,97,75,22,5,166,1267,4
9,99,86,13,5,94,78,16,5,166,1267,4
10,114,94,20,5,91,77,14,5,166,1267,4
1,59,43,16,5,79,66,13,5,368,787,4
2,79,52,27,5,80,63,17,5,368,787,4
3,66,47,19,5,79,61,18,5,368,787,4
4,65,45,20,5,87,63,24,5,368,787,4
5,65,43,22,5,68,47,21,5,368,787,4
6,56,36,20,5,81,61,20,5,368,787,4
7,64,41,23,5,70,56,14,5,368,787,4
8,53,33,20,5,70,59,11,5,368,787,4
9,43,35,8,5,56,45,11,5,368,787,4
10,62,41,21,5,71,57,14,5,368,787,4
1,80,53,27,5,79,63,16,5,310,3404,4
2,61,46,15,5,76,60,16,5,310,3404,4
3,66,46,20,5,61,48,13,5,310,3404,4
4,64,44,20,5,72,53,19,5,310,3404,4
5,51,36,15,5,75,55,20,5,310,3404,4
6,59,38,21,5,64,52,12,5,310,3404,4
7,53,36,17,5,77,61,16,5,310,3404,4
8,59,36,23,5,81,64,17,5,310,3404,4
9,48,33,15,5,71,56,15,5,310,3404,4
10,60,38,22,5,78,60,18,5,310,3404,4
1,50,35,15,5,74,58,16,5,498,1179,4
2,61,38,23,5,83,66,17,5,498,1179,4
3,66,42,24,5,82,64,18,5,498,1179,4
4,47,32,15,5,82,68,14,5,498,1179,4
5,61,38,23,5,68,53,15,5,498,1179,4
6,61,40,21,5,75,54,21,5,498,1179,4
7,59,35,24,5,72,53,19,5,498,1179,4
8,44,29,15,5,64,51,13,5,498,1179,4
9,61,36,25,5,55,43,12,5,498,1179,4
10,46,31,15,5,73,56,17,5,498,1179,4
1,67,48,19,5,66,53,13,5,344,3059,4
2,62,47,15,5,73,50,23,5,344,3059,4
3,76,48,28,5,61,53,8,5,344,3059,4
4,62,40,22,5,91,73,18,5,344,3059,4
5,52,37,15,5,95,73,22,5,344,3059,4
6,59,38,21,5,71,59,12,5,344,3059,4
7,57,39,18,5,64,49,15,5,344,3059,4
8,71,45,26,5,73,59,14,5,344,3059,4
9,48,32,16,5,75,55,20,5,344,3059,4
10,55,39,16,5,65,46,19,5,344,3059,4
1,98,79,19,5,90,75,15,5,116,813,4
2,101,85,16,5,94,78,16,5,116,813,4
3,119,100,19,5,92,76,16,5,116,813,4
4,119,98,21,5,96,77,19,5,116,813,4
5,121,96,25,5,92,77,15,5,116,813,4
6,113,95,18,5,89,74,15,5,116,813,4
7,89,73,16,5,89,75,14,5,116,813,4
8,105,82,23,5,97,75,22,5,116,813,4
9,99,86,13,5,94,78,16,5,116,813,4
10,114,94,20,5,91,77,14,5,116,813,4
1,101,82,19,5,92,75,17,5,260,3257,4
2,109,89,20,5,93,74,19,5,260,3257,4
3,115,97,18,5,94,74,20,5,260,3257,4
4,124,106,18,5,93,79,14,5,260,3257,4
5,119,91,28,5,92,76,16,5,260,3257,4
6,110,94,16,5,91,78,13,5,260,3257,4
7,88,72,16,5,91,75,16,5,260,3257,4
8,84,68,16,5,95,79,16,5,260,3257,4
9,107,90,17,5,89,76,13,5,260,3257,4
10,115,93,22,5,94,76,18,5,260,3257,4
1,91,79,12,5,89,74,15,5,288,2131,4
2,120,96,24,5,93,77,16,5,288,2131,4
3,121,104,17,5,93,75,18,5,288,2131,4
4,130,107,23,5,101,78,23,5,288,2131,4
5,117,92,25,5,93,73,20,5,288,2131,4
6,110,92,18,5,89,75,14,5,288,2131,4
7,90,72,18,5,87,74,13,5,288,2131,4
8,89,72,17,5,93,77,16,5,288,2131,4
9,104,85,19,5,88,77,11,5,288,2131,4
10,110,93,17,5,92,76,16,5,288,2131,4
1,98,79,19,5,90,75,15,5,53,2313,4
2,101,85,16,5,94,78,16,5,53,2313,4
3,119,100,19,5,92,76,16,5,53,2313,4
4,119,98,21,5,96,77,19,5,53,2313,4
5,121,96,25,5,92,77,15,5,53,2313,4
6,113,95,18,5,89,74,15,5,53,2313,4
7,89,73,16,5,89,75,14,5,53,2313,4
8,105,82,23,5,97,75,22,5,53,2313,4
9,99,86,13,5,94,78,16,5,53,2313,4
10,114,94,20,5,91,77,14,5,53,2313,4
1,96,71,25,5,100,82,18,5,264,857,4
2,94,70,24,5,104,80,24,5,264,857,4
3,94,70,24,5,101,80,21,5,264,857,4
4,95,69,26,5,102,81,21,5,264,857,4
5,94,68,26,5,105,84,21,5,264,857,4
6,98,68,30,5,104,82,22,5,264,857,4
7,96,69,27,5,98,81,17,5,264,857,4
8,95,66,29,5,102,83,19,5,264,857,4
9,99,71,28,5,100,87,13,5,264,857,4
10,100,69,31,5,98,84,14,5,264,857,4
1,98,79,19,5,90,75,15,5,236,726,4
2,101,85,16,5,94,78,16,5,236,726,4
3,119,100,19,5,92,76,16,5,236,726,4
4,119,98,21,5,96,77,19,5,236,726,4
5,121,96,25,5,92,77,15,5,236,726,4
6,113,95,18,5,89,74,15,5,236,726,4
7,89,73,16,5,89,75,14,5,236,726,4
8,105,82,23,5,97,75,22,5,236,726,4
9,99,86,13,5,94,78,16,5,236,726,4
10,114,94,20,5,91,77,14,5,236,726,4
1,91,79,12,5,89,74,15,5,134,2514,4
2,120,96,24,5,93,77,16,5,134,2514,4
3,121,104,17,5,93,75,18,5,134,2514,4
4,130,107,23,5,101,78,23,5,134,2514,4
5,117,92,25,5,93,73,20,5,134,2514,4
6,110,92,18,5,89,75,14,5,134,2514,4
7,90,72,18,5,87,74,13,5,134,2514,4
8,89,72,17,5,93,77,16,5,134,2514,4
9,104,85,19,5,88,77,11,5,134,2514,4
10,110,93,17,5,92,76,16,5,134,2514,4
1,57,38,19,5,71,54,17,5,391,2981,4
2,66,40,26,5,75,60,15,5,391,2981,4
3,57,37,20,5,68,56,12,5,391,2981,4
4,42,34,8,5,73,59,14,5,391,2981,4
5,47,31,16,5,72,61,11,5,391,2981,4
6,54,38,16,5,66,53,13,5,391,2981,4
7,55,34,21,5,82,60,22,5,391,2981,4
8,57,33,24,5,79,60,19,5,391,2981,4
9,54,33,21,5,79,60,19,5,391,2981,4
10,64,36,28,5,86,65,21,5,391,2981,4
1,53,38,15,5,81,65,16,5,484,383,4
2,59,38,21,5,80,65,15,5,484,383,4
3,69,43,26,5,77,60,17,5,484,383,4
4,70,41,29,5,87,64,23,5,484,383,4
5,51,30,21,5,62,48,14,5,484,383,4
6,49,32,17,5,69,55,14,5,484,383,4
7,56,36,20,5,62,49,13,5,484,383,4
8,58,36,22,5,66,55,11,5,484,383,4
9,49,35,14,5,72,56,16,5,484,383,4
10,53,35,18,5,78,55,23,5,484,383,4
1,91,79,12,5,89,74,15,5,210,3689,4
2,120,96,24,5,93,77,16,5,210,3689,4
3,121,104,17,5,93,75,18,5,210,3689,4
4,130,107,23,5,101,78,23,5,210,3689,4
5,117,92,25,5,93,73,20,5,210,3689,4
6,110,92,18,5,89,75,14,5,210,3689,4
7,90,72,18,5,87,74,13,5,210,3689,4
8,89,72,17,5,93,77,16,5,210,3689,4
9,104,85,19,5,88,77,11,5,210,3689,4
10,110,93,17,5,92,76,16,5,210,3689,4
1,93,77,16,5,92,76,16,5,6,99,4
2,99,83,16,5,94,76,18,5,6,99,4
3,115,98,17,5,93,76,17,5,6,99,4
4,121,102,19,5,94,76,18,5,6,99,4
5,130,104,26,5,95,80,15,5,6,99,4
6,121,99,22,5,92,76,16,5,6,99,4
7,97,79,18,5,92,75,17,5,6,99,4
8,86,69,17,5,95,78,17,5,6,99,4
9,109,89,20,5,88,77,11,5,6,99,4
10,110,91,19,5,95,78,17,5,6,99,4
1,98,79,19,5,90,75,15,5,214,1257,4
2,101,85,16,5,94,78,16,5,214,1257,4
3,119,100,19,5,92,76,16,5,214,1257,4
4,119,98,21,5,96,77,19,5,214,1257,4
5,121,96,25,5,92,77,15,5,214,1257,4
6,113,95,18,5,89,74,15,5,214,1257,4
7,89,73,16,5,89,75,14,5,214,1257,4
8,105,82,23,5,97,75,22,5,214,1257,4
9,99,86,13,5,94,78,16,5,214,1257,4
10,114,94,20,5,91,77,14,5,214,1257,4
1,98,79,19,5,90,75,15,5,111,3322,4
2,101,85,16,5,94,78,16,5,111,3322,4
3,119,100,19,5,92,76,16,5,111,3322,4
4,119,98,21,5,96,77,19,5,111,3322,4
5,121,96,25,5,92,77,15,5,111,3322,4
6,113,95,18,5,89,74,15,5,111,3322,4
7,89,73,16,5,89,75,14,5,111,3322,4
8,105,82,23,5,97,75,22,5,111,3322,4
9,99,86,13,5,94,78,16,5,111,3322,4
10,114,94,20,5,91,77,14,5,111,3322,4
1,98,79,19,5,90,75,15,5,106,3081,4
2,101,85,16,5,94,78,16,5,106,3081,4
3,119,100,19,5,92,76,16,5,106,3081,4
4,119,98,21,5,96,77,19,5,106,3081,4
5,121,96,25,5,92,77,15,5,106,3081,4
6,113,95,18,5,89,74,15,5,106,3081,4
7,89,73,16,5,89,75,14,5,106,3081,4
8,105,82,23,5,97,75,22,5,106,3081,4
9,99,86,13,5,94,78,16,5,106,3081,4
10,114,94,20,5,91,77,14,5,106,3081,4
1,98,79,19,5,90,75,15,5,13,3536,4
2,101,85,16,5,94,78,16,5,13,3536,4
3,119,100,19,5,92,76,16,5,13,3536,4
4,119,98,21,5,96,77,19,5,13,3536,4
5,121,96,25,5,92,77,15,5,13,3536,4
6,113,95,18,5,89,74,15,5,13,3536,4
7,89,73,16,5,89,75,14,5,13,3536,4
8,105,82,23,5,97,75,22,5,13,3536,4
9,99,86,13,5,94,78,16,5,13,3536,4
10,114,94,20,5,91,77,14,5,13,3536,4
1,98,79,19,5,90,75,15,5,125,503,4
2,101,85,16,5,94,78,16,5,125,503,4
3,119,100,19,5,92,76,16,5,125,503,4
4,119,98,21,5,96,77,19,5,125,503,4
5,121,96,25,5,92,77,15,5,125,503,4
6,113,95,18,5,89,74,15,5,125,503,4
7,89,73,16,5,89,75,14,5,125,503,4
8,105,82,23,5,97,75,22,5,125,503,4
9,99,86,13,5,94,78,16,5,125,503,4
10,114,94,20,5,91,77,14,5,125,503,4
1,71,39,32,5,93,71,22,5,471,1747,4
2,65,39,26,5,97,72,25,5,471,1747,4
3,70,42,28,5,76,51,25,5,471,1747,4
4,63,43,20,5,86,61,25,5,471,1747,4
5,64,37,27,5,75,54,21,5,471,1747,4
6,59,40,19,5,72,55,17,5,471,1747,4
7,73,45,28,5,91,63,28,5,471,1747,4
8,80,51,29,5,96,73,23,5,471,1747,4
9,68,42,26,5,98,78,20,5,471,1747,4
10,66,40,26,5,94,75,19,5,471,1747,4
1,56,36,20,5,78,62,16,5,460,3104,4
2,56,38,18,5,67,54,13,5,460,3104,4
3,53,38,15,5,79,61,18,5,460,3104,4
4,51,34,17,5,75,59,16,5,460,3104,4
5,56,34,22,5,69,54,15,5,460,3104,4
6,55,38,17,5,72,56,16,5,460,3104,4
7,52,34,18,5,74,59,15,5,460,3104,4
8,59,33,26,5,74,54,20,5,460,3104,4
9,56,31,25,5,63,51,12,5,460,3104,4
10,57,34,23,5,79,58,21,5,460,3104,4
1,55,36,19,5,72,55,17,5,436,290,4
2,60,38,22,5,81,64,17,5,436,290,4
3,64,41,23,5,81,63,18,5,436,290,4
4,59,36,23,5,73,61,12,5,436,290,4
5,57,35,22,5,70,52,18,5,436,290,4
6,55,37,18,5,83,67,16,5,436,290,4
7,58,34,24,5,65,52,13,5,436,290,4
8,50,32,18,5,76,57,19,5,436,290,4
9,49,31,18,5,70,54,16,5,436,290,4
10,43,29,14,5,71,54,17,5,436,290,4
1,134,95,39,5,122,100,22,5,240,927,4
2,132,97,35,5,120,96,24,5,240,927,4
3,131,96,35,5,117,94,23,5,240,927,4
4,132,94,38,5,117,96,21,5,240,927,4
5,133,99,34,5,118,90,28,5,240,927,4
6,119,92,27,5,116,95,21,5,240,927,4
7,129,99,30,5,113,95,18,5,240,927,4
8,128,100,28,5,113,91,22,5,240,927,4
9,129,97,32,5,117,97,20,5,240,927,4
10,128,93,35,5,119,96,23,5,240,927,4
1,56,41,15,5,74,65,9,5,395,79,4
2,67,47,20,5,80,62,18,5,395,79,4
3,90,57,33,5,82,62,20,5,395,79,4
4,63,48,15,5,78,58,20,5,395,79,4
5,59,38,21,5,61,48,13,5,395,79,4
6,64,41,23,5,56,43,13,5,395,79,4
7,70,48,22,5,63,46,17,5,395,79,4
8,49,39,10,5,78,60,18,5,395,79,4
9,60,42,18,5,65,51,14,5,395,79,4
10,63,40,23,5,87,66,21,5,395,79,4
1,91,79,12,5,89,74,15,5,193,528,4
2,120,96,24,5,93,77,16,5,193,528,4
3,121,104,17,5,93,75,18,5,193,528,4
4,130,107,23,5,101,78,23,5,193,528,4
5,117,92,25,5,93,73,20,5,193,528,4
6,110,92,18,5,89,75,14,5,193,528,4
7,90,72,18,5,87,74,13,5,193,528,4
8,89,72,17,5,93,77,16,5,193,528,4
9,104,85,19,5,88,77,11,5,193,528,4
10,110,93,17,5,92,76,16,5,193,528,4
1,98,79,19,5,90,75,15,5,14,624,4
2,101,85,16,5,94,78,16,5,14,624,4
3,119,100,19,5,92,76,16,5,14,624,4
4,119,98,21,5,96,77,19,5,14,624,4
5,121,96,25,5,92,77,15,5,14,624,4
6,113,95,18,5,89,74,15,5,14,624,4
7,89,73,16,5,89,75,14,5,14,624,4
8,105,82,23,5,97,75,22,5,14,624,4
9,99,86,13,5,94,78,16,5,14,624,4
10,114,94,20,5,91,77,14,5,14,624,4
1,98,79,19,5,90,75,15,5,71,2009,4
2,101,85,16,5,94,78,16,5,71,2009,4
3,119,100,19,5,92,76,16,5,71,2009,4
4,119,98,21,5,96,77,19,5,71,2009,4
5,121,96,25,5,92,77,15,5,71,2009,4
6,113,95,18,5,89,74,15,5,71,2009,4
7,89,73,16,5,89,75,14,5,71,2009,4
8,105,82,23,5,97,75,22,5,71,2009,4
9,99,86,13,5,94,78,16,5,71,2009,4
10,114,94,20,5,91,77,14,5,71,2009,4
1,98,79,19,5,90,75,15,5,108,3764,4
2,101,85,16,5,94,78,16,5,108,3764,4
3,119,100,19,5,92,76,16,5,108,3764,4
4,119,98,21,5,96,77,19,5,108,3764,4
5,121,96,25,5,92,77,15,5,108,3764,4
6,113,95,18,5,89,74,15,5,108,3764,4
7,89,73,16,5,89,75,14,5,108,3764,4
8,105,82,23,5,97,75,22,5,108,3764,4
9,99,86,13,5,94,78,16,5,108,3764,4
10,114,94,20,5,91,77,14,5,108,3764,4
1,62,42,20,5,82,63,19,5,311,2531,4
2,62,46,16,5,76,63,13,5,311,2531,4
3,75,50,25,5,73,60,13,5,311,2531,4
4,72,46,26,5,86,66,20,5,311,2531,4
5,54,36,18,5,74,56,18,5,311,2531,4
6,58,39,19,5,67,51,16,5,311,2531,4
7,55,37,18,5,77,60,17,5,311,2531,4
8,48,34,14,5,74,55,19,5,311,2531,4
9,64,40,24,5,55,44,11,5,311,2531,4
10,56,37,19,5,76,60,16,5,311,2531,4
1,55,36,19,5,72,55,17,5,436,1952,4
2,60,38,22,5,81,64,17,5,436,1952,4
3,64,41,23,5,81,63,18,5,436,1952,4
4,59,36,23,5,73,61,12,5,436,1952,4
5,57,35,22,5,70,52,18,5,436,1952,4
6,55,37,18,5,83,67,16,5,436,1952,4
7,58,34,24,5,65,52,13,5,436,1952,4
8,50,32,18,5,76,57,19,5,436,1952,4
9,49,31,18,5,70,54,16,5,436,1952,4
10,43,29,14,5,71,54,17,5,436,1952,4
1,57,38,19,5,71,54,17,5,391,832,4
2,66,40,26,5,75,60,15,5,391,832,4
3,57,37,20,5,68,56,12,5,391,832,4
4,42,34,8,5,73,59,14,5,391,832,4
5,47,31,16,5,72,61,11,5,391,832,4
6,54,38,16,5,66,53,13,5,391,832,4
7,55,34,21,5,82,60,22,5,391,832,4
8,57,33,24,5,79,60,19,5,391,832,4
9,54,33,21,5,79,60,19,5,391,832,4
10,64,36,28,5,86,65,21,5,391,832,4
1,134,95,39,5,122,100,22,5,242,1219,4
2,132,97,35,5,120,96,24,5,242,1219,4
3,131,96,35,5,117,94,23,5,242,1219,4
4,132,94,38,5,117,96,21,5,242,1219,4
5,133,99,34,5,118,90,28,5,242,1219,4
6,119,92,27,5,116,95,21,5,242,1219,4
7,129,99,30,5,113,95,18,5,242,1219,4
8,128,100,28,5,113,91,22,5,242,1219,4
9,129,97,32,5,117,97,20,5,242,1219,4
10,128,93,35,5,119,96,23,5,242,1219,4
1,98,79,19,5,90,75,15,5,104,1761,4
2,101,85,16,5,94,78,16,5,104,1761,4
3,119,100,19,5,92,76,16,5,104,1761,4
4,119,98,21,5,96,77,19,5,104,1761,4
5,121,96,25,5,92,77,15,5,104,1761,4
6,113,95,18,5,89,74,15,5,104,1761,4
7,89,73,16,5,89,75,14,5,104,1761,4
8,105,82,23,5,97,75,22,5,104,1761,4
9,99,86,13,5,94,78,16,5,104,1761,4
10,114,94,20,5,91,77,14,5,104,1761,4
1,69,49,20,5,81,61,20,5,330,1226,4
2,66,47,19,5,77,60,17,5,330,1226,4
3,73,50,23,5,66,52,14,5,330,1226,4
4,70,44,26,5,83,69,14,5,330,1226,4
5,58,37,21,5,70,57,13,5,330,1226,4
6,58,37,21,5,72,57,15,5,330,1226,4
7,60,38,22,5,83,62,21,5,330,1226,4
8,48,33,15,5,78,60,18,5,330,1226,4
9,56,37,19,5,57,41,16,5,330,1226,4
10,49,35,14,5,64,50,14,5,330,1226,4
1,98,79,19,5,90,75,15,5,26,3208,4
2,101,85,16,5,94,78,16,5,26,3208,4
3,119,100,19,5,92,76,16,5,26,3208,4
4,119,98,21,5,96,77,19,5,26,3208,4
5,121,96,25,5,92,77,15,5,26,3208,4
6,113,95,18,5,89,74,15,5,26,3208,4
7,89,73,16,5,89,75,14,5,26,3208,4
8,105,82,23,5,97,75,22,5,26,3208,4
9,99,86,13,5,94,78,16,5,26,3208,4
10,114,94,20,5,91,77,14,5,26,3208,4
1,61,42,19,5,74,56,18,5,386,219,4
2,77,47,30,5,91,72,19,5,386,219,4
3,52,37,15,5,73,58,15,5,386,219,4
4,50,34,16,5,83,67,16,5,386,219,4
5,51,32,19,5,62,53,9,5,386,219,4
6,44,32,12,5,71,56,15,5,386,219,4
7,51,38,13,5,81,59,22,5,386,219,4
8,59,39,20,5,55,46,9,5,386,219,4
9,73,42,31,5,75,56,19,5,386,219,4
10,57,38,19,5,83,61,22,5,386,219,4
1,91,79,12,5,89,74,15,5,230,2118,4
2,120,96,24,5,93,77,16,5,230,2118,4
3,121,104,17,5,93,75,18,5,230,2118,4
4,130,107,23,5,101,78,23,5,230,2118,4
5,117,92,25,5,93,73,20,5,230,2118,4
6,110,92,18,5,89,75,14,5,230,2118,4
7,90,72,18,5,87,74,13,5,230,2118,4
8,89,72,17,5,93,77,16,5,230,2118,4
9,104,85,19,5,88,77,11,5,230,2118,4
10,110,93,17,5,92,76,16,5,230,2118,4
1,60,41,19,5,72,59,13,5,456,1941,4
2,57,37,20,5,82,69,13,5,456,1941,4
3,59,37,22,5,64,55,9,5,456,1941,4
4,50,34,16,5,70,53,17,5,456,1941,4
5,56,34,22,5,69,54,15,5,456,1941,4
6,57,36,21,5,72,56,16,5,456,1941,4
7,58,34,24,5,73,54,19,5,456,1941,4
8,44,29,15,5,61,46,15,5,456,1941,4
9,58,33,25,5,92,65,27,5,456,1941,4
10,53,33,20,5,74,56,18,5,456,1941,4
1,55,36,19,5,61,49,12,5,427,1868,4
2,61,38,23,5,83,62,21,5,427,1868,4
3,52,36,16,5,68,54,14,5,427,1868,4
4,44,35,9,5,72,58,14,5,427,1868,4
5,47,31,16,5,74,59,15,5,427,1868,4
6,60,40,20,5,61,52,9,5,427,1868,4
7,50,31,19,5,89,65,24,5,427,1868,4
8,52,32,20,5,76,60,16,5,427,1868,4
9,67,36,31,5,85,68,17,5,427,1868,4
10,62,35,27,5,84,63,21,5,427,1868,4
1,61,45,16,5,72,61,11,5,354,1109,4
2,68,47,21,5,75,61,14,5,354,1109,4
3,61,39,22,5,80,60,20,5,354,1109,4
4,57,41,16,5,81,62,19,5,354,1109,4
5,56,37,19,5,65,53,12,5,354,1109,4
6,80,49,31,5,71,59,12,5,354,1109,4
7,56,34,22,5,88,67,21,5,354,1109,4
8,52,37,15,5,62,47,15,5,354,1109,4
9,59,38,21,5,75,55,20,5,354,1109,4
10,48,34,14,5,75,57,18,5,354,1109,4
1,98,79,19,5,90,75,15,5,143,3018,4
2,101,85,16,5,94,78,16,5,143,3018,4
3,119,100,19,5,92,76,16,5,143,3018,4
4,119,98,21,5,96,77,19,5,143,3018,4
5,121,96,25,5,92,77,15,5,143,3018,4
6,113,95,18,5,89,74,15,5,143,3018,4
7,89,73,16,5,89,75,14,5,143,3018,4
8,105,82,23,5,97,75,22,5,143,3018,4
9,99,86,13,5,94,78,16,5,143,3018,4
10,114,94,20,5,91,77,14,5,143,3018,4
1,98,79,19,5,90,75,15,5,116,545,4
2,101,85,16,5,94,78,16,5,116,545,4
3,119,100,19,5,92,76,16,5,116,545,4
4,119,98,21,5,96,77,19,5,116,545,4
5,121,96,25,5,92,77,15,5,116,545,4
6,113,95,18,5,89,74,15,5,116,545,4
7,89,73,16,5,89,75,14,5,116,545,4
8,105,82,23,5,97,75,22,5,116,545,4
9,99,86,13,5,94,78,16,5,116,545,4
10,114,94,20,5,91,77,14,5,116,545,4
1,98,79,19,5,90,75,15,5,138,3762,4
2,101,85,16,5,94,78,16,5,138,3762,4
3,119,100,19,5,92,76,16,5,138,3762,4
4,119,98,21,5,96,77,19,5,138,3762,4
5,121,96,25,5,92,77,15,5,138,3762,4
6,113,95,18,5,89,74,15,5,138,3762,4
7,89,73,16,5,89,75,14,5,138,3762,4
8,105,82,23,5,97,75,22,5,138,3762,4
9,99,86,13,5,94,78,16,5,138,3762,4
10,114,94,20,5,91,77,14,5,138,3762,4
1,98,79,19,5,90,75,15,5,225,391,4
2,101,85,16,5,94,78,16,5,225,391,4
3,119,100,19,5,92,76,16,5,225,391,4
4,119,98,21,5,96,77,19,5,225,391,4
5,121,96,25,5,92,77,15,5,225,391,4
6,113,95,18,5,89,74,15,5,225,391,4
7,89,73,16,5,89,75,14,5,225,391,4
8,105,82,23,5,97,75,22,5,225,391,4
9,99,86,13,5,94,78,16,5,225,391,4
10,114,94,20,5,91,77,14,5,225,391,4
1,134,95,39,5,122,100,22,5,240,835,4
2,132,97,35,5,120,96,24,5,240,835,4
3,131,96,35,5,117,94,23,5,240,835,4
4,132,94,38,5,117,96,21,5,240,835,4
5,133,99,34,5,118,90,28,5,240,835,4
6,119,92,27,5,116,95,21,5,240,835,4
7,129,99,30,5,113,95,18,5,240,835,4
8,128,100,28,5,113,91,22,5,240,835,4
9,129,97,32,5,117,97,20,5,240,835,4
10,128,93,35,5,119,96,23,5,240,835,4
1,53,39,14,5,68,55,13,5,426,1373,4
2,54,39,15,5,73,56,17,5,426,1373,4
3,63,43,20,5,93,70,23,5,426,1373,4
4,63,45,18,5,86,71,15,5,426,1373,4
5,48,32,16,5,75,55,20,5,426,1373,4
6,64,41,23,5,60,45,15,5,426,1373,4
7,72,43,29,5,66,50,16,5,426,1373,4
8,66,45,21,5,69,58,11,5,426,1373,4
9,59,40,19,5,80,61,19,5,426,1373,4
10,54,35,19,5,71,57,14,5,426,1373,4
1,98,79,19,5,90,75,15,5,50,3201,4
2,101,85,16,5,94,78,16,5,50,3201,4
3,119,100,19,5,92,76,16,5,50,3201,4
4,119,98,21,5,96,77,19,5,50,3201,4
5,121,96,25,5,92,77,15,5,50,3201,4
6,113,95,18,5,89,74,15,5,50,3201,4
7,89,73,16,5,89,75,14,5,50,3201,4
8,105,82,23,5,97,75,22,5,50,3201,4
9,99,86,13,5,94,78,16,5,50,3201,4
10,114,94,20,5,91,77,14,5,50,3201,4
1,101,82,19,5,92,75,17,5,179,711,4
2,109,89,20,5,93,74,19,5,179,711,4
3,115,97,18,5,94,74,20,5,179,711,4
4,124,106,18,5,93,79,14,5,179,711,4
5,119,91,28,5,92,76,16,5,179,711,4
6,110,94,16,5,91,78,13,5,179,711,4
7,88,72,16,5,91,75,16,5,179,711,4
8,84,68,16,5,95,79,16,5,179,711,4
9,107,90,17,5,89,76,13,5,179,711,4
10,115,93,22,5,94,76,18,5,179,711,4
1,98,79,19,5,90,75,15,5,194,2650,4
2,101,85,16,5,94,78,16,5,194,2650,4
3,119,100,19,5,92,76,16,5,194,2650,4
4,119,98,21,5,96,77,19,5,194,2650,4
5,121,96,25,5,92,77,15,5,194,2650,4
6,113,95,18,5,89,74,15,5,194,2650,4
7,89,73,16,5,89,75,14,5,194,2650,4
8,105,82,23,5,97,75,22,5,194,2650,4
9,99,86,13,5,94,78,16,5,194,2650,4
10,114,94,20,5,91,77,14,5,194,2650,4
1,98,79,19,5,90,75,15,5,59,2891,4
2,101,85,16,5,94,78,16,5,59,2891,4
3,119,100,19,5,92,76,16,5,59,2891,4
4,119,98,21,5,96,77,19,5,59,2891,4
5,121,96,25,5,92,77,15,5,59,2891,4
6,113,95,18,5,89,74,15,5,59,2891,4
7,89,73,16,5,89,75,14,5,59,2891,4
8,105,82,23,5,97,75,22,5,59,2891,4
9,99,86,13,5,94,78,16,5,59,2891,4
10,114,94,20,5,91,77,14,5,59,2891,4
1,98,79,19,5,90,75,15,5,48,2501,4
2,101,85,16,5,94,78,16,5,48,2501,4
3,119,100,19,5,92,76,16,5,48,2501,4
4,119,98,21,5,96,77,19,5,48,2501,4
5,121,96,25,5,92,77,15,5,48,2501,4
6,113,95,18,5,89,74,15,5,48,2501,4
7,89,73,16,5,89,75,14,5,48,2501,4
8,105,82,23,5,97,75,22,5,48,2501,4
9,99,86,13,5,94,78,16,5,48,2501,4
10,114,94,20,5,91,77,14,5,48,2501,4
1,98,79,19,5,90,75,15,5,163,641,4
2,101,85,16,5,94,78,16,5,163,641,4
3,119,100,19,5,92,76,16,5,163,641,4
4,119,98,21,5,96,77,19,5,163,641,4
5,121,96,25,5,92,77,15,5,163,641,4
6,113,95,18,5,89,74,15,5,163,641,4
7,89,73,16,5,89,75,14,5,163,641,4
8,105,82,23,5,97,75,22,5,163,641,4
9,99,86,13,5,94,78,16,5,163,641,4
10,114,94,20,5,91,77,14,5,163,641,4
1,53,36,17,5,71,55,16,5,434,3374,4
2,65,39,26,5,80,64,16,5,434,3374,4
3,50,36,14,5,69,54,15,5,434,3374,4
4,47,36,11,5,76,62,14,5,434,3374,4
5,52,31,21,5,68,59,9,5,434,3374,4
6,57,38,19,5,65,52,13,5,434,3374,4
7,57,34,23,5,81,60,21,5,434,3374,4
8,52,34,18,5,80,61,19,5,434,3374,4
9,54,33,21,5,81,64,17,5,434,3374,4
10,63,35,28,5,88,66,22,5,434,3374,4
1,52,34,18,5,61,48,13,5,447,827,4
2,68,40,28,5,74,59,15,5,447,827,4
3,56,37,19,5,68,54,14,5,447,827,4
4,50,38,12,5,77,62,15,5,447,827,4
5,47,32,15,5,74,62,12,5,447,827,4
6,62,40,22,5,64,53,11,5,447,827,4
7,48,31,17,5,87,65,22,5,447,827,4
8,55,33,22,5,85,67,18,5,447,827,4
9,55,32,23,5,83,64,19,5,447,827,4
10,57,33,24,5,92,68,24,5,447,827,4
1,53,37,16,5,93,73,20,5,431,3028,4
2,61,40,21,5,82,67,15,5,431,3028,4
3,63,41,22,5,80,66,14,5,431,3028,4
4,54,36,18,5,66,48,18,5,431,3028,4
5,44,32,12,5,54,42,12,5,431,3028,4
6,57,37,20,5,75,55,20,5,431,3028,4
7,65,39,26,5,74,55,19,5,431,3028,4
8,48,29,19,5,59,46,13,5,431,3028,4
9,66,39,27,5,72,58,14,5,431,3028,4
10,58,35,23,5,77,59,18,5,431,3028,4
1,98,79,19,5,90,75,15,5,256,2371,4
2,101,85,16,5,94,78,16,5,256,2371,4
3,119,100,19,5,92,76,16,5,256,2371,4
4,119,98,21,5,96,77,19,5,256,2371,4
5,121,96,25,5,92,77,15,5,256,2371,4
6,113,95,18,5,89,74,15,5,256,2371,4
7,89,73,16,5,89,75,14,5,256,2371,4
8,105,82,23,5,97,75,22,5,256,2371,4
9,99,86,13,5,94,78,16,5,256,2371,4
10,114,94,20,5,91,77,14,5,256,2371,4
1,98,79,19,5,90,75,15,5,191,3156,4
2,101,85,16,5,94,78,16,5,191,3156,4
3,119,100,19,5,92,76,16,5,191,3156,4
4,119,98,21,5,96,77,19,5,191,3156,4
5,121,96,25,5,92,77,15,5,191,3156,4
6,113,95,18,5,89,74,15,5,191,3156,4
7,89,73,16,5,89,75,14,5,191,3156,4
8,105,82,23,5,97,75,22,5,191,3156,4
9,99,86,13,5,94,78,16,5,191,3156,4
10,114,94,20,5,91,77,14,5,191,3156,4
1,98,79,19,5,90,75,15,5,187,711,4
2,101,85,16,5,94,78,16,5,187,711,4
3,119,100,19,5,92,76,16,5,187,711,4
4,119,98,21,5,96,77,19,5,187,711,4
5,121,96,25,5,92,77,15,5,187,711,4
6,113,95,18,5,89,74,15,5,187,711,4
7,89,73,16,5,89,75,14,5,187,711,4
8,105,82,23,5,97,75,22,5,187,711,4
9,99,86,13,5,94,78,16,5,187,711,4
10,114,94,20,5,91,77,14,5,187,711,4
1,54,37,17,5,76,58,18,5,440,1288,4
2,53,37,16,5,88,69,19,5,440,1288,4
3,60,38,22,5,72,62,10,5,440,1288,4
4,57,37,20,5,73,57,16,5,440,1288,4
5,67,41,26,5,72,57,15,5,440,1288,4
6,60,35,25,5,86,65,21,5,440,1288,4
7,52,32,20,5,72,55,17,5,440,1288,4
8,46,30,16,5,68,52,16,5,440,1288,4
9,54,32,22,5,74,57,17,5,440,1288,4
10,49,32,17,5,70,56,14,5,440,1288,4
1,98,79,19,5,90,75,15,5,163,3647,4
2,101,85,16,5,94,78,16,5,163,3647,4
3,119,100,19,5,92,76,16,5,163,3647,4
4,119,98,21,5,96,77,19,5,163,3647,4
5,121,96,25,5,92,77,15,5,163,3647,4
6,113,95,18,5,89,74,15,5,163,3647,4
7,89,73,16,5,89,75,14,5,163,3647,4
8,105,82,23,5,97,75,22,5,163,3647,4
9,99,86,13,5,94,78,16,5,163,3647,4
10,114,94,20,5,91,77,14,5,163,3647,4
1,98,79,19,5,90,75,15,5,182,1656,4
2,101,85,16,5,94,78,16,5,182,1656,4
3,119,100,19,5,92,76,16,5,182,1656,4
4,119,98,21,5,96,77,19,5,182,1656,4
5,121,96,25,5,92,77,15,5,182,1656,4
6,113,95,18,5,89,74,15,5,182,1656,4
7,89,73,16,5,89,75,14,5,182,1656,4
8,105,82,23,5,97,75,22,5,182,1656,4
9,99,86,13,5,94,78,16,5,182,1656,4
10,114,94,20,5,91,77,14,5,182,1656,4
1,64,45,19,5,83,64,19,5,370,750,4
2,55,42,13,5,85,68,17,5,370,750,4
3,73,47,26,5,67,55,12,5,370,750,4
4,63,45,18,5,81,64,17,5,370,750,4
5,61,40,21,5,72,55,17,5,370,750,4
6,64,41,23,5,57,44,13,5,370,750,4
7,59,38,21,5,73,58,15,5,370,750,4
8,66,46,20,5,77,62,15,5,370,750,4
9,53,36,17,5,66,52,14,5,370,750,4
10,61,38,23,5,81,58,23,5,370,750,4
1,98,79,19,5,90,75,15,5,46,2262,4
2,101,85,16,5,94,78,16,5,46,2262,4
3,119,100,19,5,92,76,16,5,46,2262,4
4,119,98,21,5,96,77,19,5,46,2262,4
5,121,96,25,5,92,77,15,5,46,2262,4
6,113,95,18,5,89,74,15,5,46,2262,4
7,89,73,16,5,89,75,14,5,46,2262,4
8,105,82,23,5,97,75,22,5,46,2262,4
9,99,86,13,5,94,78,16,5,46,2262,4
10,114,94,20,5,91,77,14,5,46,2262,4
1,98,79,19,5,90,75,15,5,147,2484,4
2,101,85,16,5,94,78,16,5,147,2484,4
3,119,100,19,5,92,76,16,5,147,2484,4
4,119,98,21,5,96,77,19,5,147,2484,4
5,121,96,25,5,92,77,15,5,147,2484,4
6,113,95,18,5,89,74,15,5,147,2484,4
7,89,73,16,5,89,75,14,5,147,2484,4
8,105,82,23,5,97,75,22,5,147,2484,4
9,99,86,13,5,94,78,16,5,147,2484,4
10,114,94,20,5,91,77,14,5,147,2484,4
1,98,79,19,5,90,75,15,5,44,3619,4
2,101,85,16,5,94,78,16,5,44,3619,4
3,119,100,19,5,92,76,16,5,44,3619,4
4,119,98,21,5,96,77,19,5,44,3619,4
5,121,96,25,5,92,77,15,5,44,3619,4
6,113,95,18,5,89,74,15,5,44,3619,4
7,89,73,16,5,89,75,14,5,44,3619,4
8,105,82,23,5,97,75,22,5,44,3619,4
9,99,86,13,5,94,78,16,5,44,3619,4
10,114,94,20,5,91,77,14,5,44,3619,4
1,57,38,19,5,71,54,17,5,391,811,4
2,66,40,26,5,75,60,15,5,391,811,4
3,57,37,20,5,68,56,12,5,391,811,4
4,42,34,8,5,73,59,14,5,391,811,4
5,47,31,16,5,72,61,11,5,391,811,4
6,54,38,16,5,66,53,13,5,391,811,4
7,55,34,21,5,82,60,22,5,391,811,4
8,57,33,24,5,79,60,19,5,391,811,4
9,54,33,21,5,79,60,19,5,391,811,4
10,64,36,28,5,86,65,21,5,391,811,4
1,98,79,19,5,90,75,15,5,43,879,4
2,101,85,16,5,94,78,16,5,43,879,4
3,119,100,19,5,92,76,16,5,43,879,4
4,119,98,21,5,96,77,19,5,43,879,4
5,121,96,25,5,92,77,15,5,43,879,4
6,113,95,18,5,89,74,15,5,43,879,4
7,89,73,16,5,89,75,14,5,43,879,4
8,105,82,23,5,97,75,22,5,43,879,4
9,99,86,13,5,94,78,16,5,43,879,4
10,114,94,20,5,91,77,14,5,43,879,4
1,69,46,23,5,76,59,17,5,316,1116,4
2,69,47,22,5,73,57,16,5,316,1116,4
3,80,52,28,5,80,62,18,5,316,1116,4
4,69,48,21,5,84,67,17,5,316,1116,4
5,57,37,20,5,71,58,13,5,316,1116,4
6,59,37,22,5,66,52,14,5,316,1116,4
7,45,34,11,5,69,53,16,5,316,1116,4
8,55,36,19,5,70,56,14,5,316,1116,4
9,57,38,19,5,65,50,15,5,316,1116,4
10,50,33,17,5,87,64,23,5,316,1116,4
1,91,79,12,5,89,74,15,5,200,3202,4
2,120,96,24,5,93,77,16,5,200,3202,4
3,121,104,17,5,93,75,18,5,200,3202,4
4,130,107,23,5,101,78,23,5,200,3202,4
5,117,92,25,5,93,73,20,5,200,3202,4
6,110,92,18,5,89,75,14,5,200,3202,4
7,90,72,18,5,87,74,13,5,200,3202,4
8,89,72,17,5,93,77,16,5,200,3202,4
9,104,85,19,5,88,77,11,5,200,3202,4
10,110,93,17,5,92,76,16,5,200,3202,4
1,137,97,40,5,125,101,24,5,241,92,4
2,130,93,37,5,122,95,27,5,241,92,4
3,129,93,36,5,118,93,25,5,241,92,4
4,132,95,37,5,116,97,19,5,241,92,4
5,134,100,34,5,116,93,23,5,241,92,4
6,120,93,27,5,114,95,19,5,241,92,4
7,129,101,28,5,116,99,17,5,241,92,4
8,131,101,30,5,115,95,20,5,241,92,4
9,129,99,30,5,118,97,21,5,241,92,4
10,128,94,34,5,119,93,26,5,241,92,4
1,57,38,19,5,71,54,17,5,469,3773,4
2,66,40,26,5,75,60,15,5,469,3773,4
3,57,37,20,5,68,56,12,5,469,3773,4
4,42,34,8,5,73,59,14,5,469,3773,4
5,47,31,16,5,72,61,11,5,469,3773,4
6,54,38,16,5,66,53,13,5,469,3773,4
7,55,34,21,5,82,60,22,5,469,3773,4
8,57,33,24,5,79,60,19,5,469,3773,4
9,54,33,21,5,79,60,19,5,469,3773,4
10,64,36,28,5,86,65,21,5,469,3773,4
1,98,79,19,5,90,75,15,5,85,1021,4
2,101,85,16,5,94,78,16,5,85,1021,4
3,119,100,19,5,92,76,16,5,85,1021,4
4,119,98,21,5,96,77,19,5,85,1021,4
5,121,96,25,5,92,77,15,5,85,1021,4
6,113,95,18,5,89,74,15,5,85,1021,4
7,89,73,16,5,89,75,14,5,85,1021,4
8,105,82,23,5,97,75,22,5,85,1021,4
9,99,86,13,5,94,78,16,5,85,1021,4
10,114,94,20,5,91,77,14,5,85,1021,4
1,98,79,19,5,90,75,15,5,58,2252,4
2,101,85,16,5,94,78,16,5,58,2252,4
3,119,100,19,5,92,76,16,5,58,2252,4
4,119,98,21,5,96,77,19,5,58,2252,4
5,121,96,25,5,92,77,15,5,58,2252,4
6,113,95,18,5,89,74,15,5,58,2252,4
7,89,73,16,5,89,75,14,5,58,2252,4
8,105,82,23,5,97,75,22,5,58,2252,4
9,99,86,13,5,94,78,16,5,58,2252,4
10,114,94,20,5,91,77,14,5,58,2252,4
1,68,51,17,5,85,67,18,5,365,1902,4
2,64,45,19,5,89,70,19,5,365,1902,4
3,68,42,26,5,80,65,15,5,365,1902,4
4,59,38,21,5,79,64,15,5,365,1902,4
5,62,41,21,5,80,65,15,5,365,1902,4
6,61,37,24,5,72,55,17,5,365,1902,4
7,61,38,23,5,52,42,10,5,365,1902,4
8,52,36,16,5,70,51,19,5,365,1902,4
9,63,44,19,5,54,42,12,5,365,1902,4
10,62,43,19,5,86,64,22,5,365,1902,4
1,98,79,19,5,90,75,15,5,91,3233,4
2,101,85,16,5,94,78,16,5,91,3233,4
3,119,100,19,5,92,76,16,5,91,3233,4
4,119,98,21,5,96,77,19,5,91,3233,4
5,121,96,25,5,92,77,15,5,91,3233,4
6,113,95,18,5,89,74,15,5,91,3233,4
7,89,73,16,5,89,75,14,5,91,3233,4
8,105,82,23,5,97,75,22,5,91,3233,4
9,99,86,13,5,94,78,16,5,91,3233,4
10,114,94,20,5,91,77,14,5,91,3233,4
1,62,42,20,5,85,67,18,5,398,1946,4
2,59,39,20,5,81,65,16,5,398,1946,4
3,53,38,15,5,73,56,17,5,398,1946,4
4,49,36,13,5,58,43,15,5,398,1946,4
5,55,33,22,5,62,50,12,5,398,1946,4
6,61,37,24,5,77,58,19,5,398,1946,4
7,52,33,19,5,77,60,17,5,398,1946,4
8,46,30,16,5,63,51,12,5,398,1946,4
9,58,34,24,5,78,60,18,5,398,1946,4
10,69,38,31,5,82,64,18,5,398,1946,4
1,106,55,51,5,93,62,31,5,504,1508,4
2,100,50,50,5,98,62,36,5,504,1508,4
3,104,55,49,5,96,59,37,5,504,1508,4
4,109,55,54,5,99,59,40,5,504,1508,4
5,106,53,53,5,102,62,40,5,504,1508,4
6,111,58,53,5,103,60,43,5,504,1508,4
7,109,55,54,5,100,61,39,5,504,1508,4
8,107,55,52,5,94,60,34,5,504,1508,4
9,108,55,53,5,94,64,30,5,504,1508,4
10,114,58,56,5,91,63,28,5,504,1508,4
1,91,79,12,5,89,74,15,5,139,3080,4
2,120,96,24,5,93,77,16,5,139,3080,4
3,121,104,17,5,93,75,18,5,139,3080,4
4,130,107,23,5,101,78,23,5,139,3080,4
5,117,92,25,5,93,73,20,5,139,3080,4
6,110,92,18,5,89,75,14,5,139,3080,4
7,90,72,18,5,87,74,13,5,139,3080,4
8,89,72,17,5,93,77,16,5,139,3080,4
9,104,85,19,5,88,77,11,5,139,3080,4
10,110,93,17,5,92,76,16,5,139,3080,4
1,95,73,22,5,105,84,21,5,8,456,4
2,94,73,21,5,103,85,18,5,8,456,4
3,94,74,20,5,102,85,17,5,8,456,4
4,104,75,29,5,99,86,13,5,8,456,4
5,99,71,28,5,99,83,16,5,8,456,4
6,98,67,31,5,100,80,20,5,8,456,4
7,104,72,32,5,104,84,20,5,8,456,4
8,96,67,29,5,103,85,18,5,8,456,4
9,105,75,30,5,102,78,24,5,8,456,4
10,93,73,20,5,100,77,23,5,8,456,4
1,52,37,15,5,59,47,12,5,458,3235,4
2,66,40,26,5,73,59,14,5,458,3235,4
3,55,37,18,5,67,54,13,5,458,3235,4
4,46,34,12,5,74,60,14,5,458,3235,4
5,48,32,16,5,71,60,11,5,458,3235,4
6,59,39,20,5,62,51,11,5,458,3235,4
7,53,32,21,5,93,69,24,5,458,3235,4
8,55,32,23,5,84,63,21,5,458,3235,4
9,59,35,24,5,94,69,25,5,458,3235,4
10,60,36,24,5,79,61,18,5,458,3235,4
1,58,37,21,5,82,60,22,5,429,3316,4
2,63,40,23,5,85,66,19,5,429,3316,4
3,65,41,24,5,77,61,16,5,429,3316,4
4,56,35,21,5,74,62,12,5,429,3316,4
5,55,35,20,5,64,51,13,5,429,3316,4
6,50,36,14,5,80,62,18,5,429,3316,4
7,49,30,19,5,76,57,19,5,429,3316,4
8,55,33,22,5,67,51,16,5,429,3316,4
9,54,32,22,5,69,54,15,5,429,3316,4
10,44,30,14,5,64,51,13,5,429,3316,4
1,98,79,19,5,90,75,15,5,229,1623,4
2,101,85,16,5,94,78,16,5,229,1623,4
3,119,100,19,5,92,76,16,5,229,1623,4
4,119,98,21,5,96,77,19,5,229,1623,4
5,121,96,25,5,92,77,15,5,229,1623,4
6,113,95,18,5,89,74,15,5,229,1623,4
7,89,73,16,5,89,75,14,5,229,1623,4
8,105,82,23,5,97,75,22,5,229,1623,4
9,99,86,13,5,94,78,16,5,229,1623,4
10,114,94,20,5,91,77,14,5,229,1623,4
1,58,41,17,5,97,77,20,5,411,743,4
2,65,42,23,5,73,59,14,5,411,743,4
3,55,35,20,5,66,49,17,5,411,743,4
4,50,34,16,5,71,54,17,5,411,743,4
5,54,35,19,5,79,59,20,5,411,743,4
6,49,33,16,5,81,61,20,5,411,743,4
7,50,33,17,5,74,58,16,5,411,743,4
8,53,33,20,5,53,42,11,5,411,743,4
9,65,38,27,5,61,48,13,5,411,743,4
10,63,37,26,5,79,62,17,5,411,743,4
1,70,39,31,5,88,69,19,5,480,3079,4
2,57,36,21,5,96,71,25,5,480,3079,4
3,68,38,30,5,96,66,30,5,480,3079,4
4,64,39,25,5,85,65,20,5,480,3079,4
5,69,36,33,5,88,65,23,5,480,3079,4
6,66,43,23,5,82,61,21,5,480,3079,4
7,73,44,29,5,74,55,19,5,480,3079,4
8,66,45,21,5,88,64,24,5,480,3079,4
9,74,46,28,5,89,67,22,5,480,3079,4
10,61,39,22,5,91,69,22,5,480,3079,4
1,53,35,18,5,56,47,9,5,466,1424,4
2,63,38,25,5,80,64,16,5,466,1424,4
3,62,41,21,5,68,56,12,5,466,1424,4
4,48,34,14,5,80,61,19,5,466,1424,4
5,50,32,18,5,71,58,13,5,466,1424,4
6,60,40,20,5,65,52,13,5,466,1424,4
7,53,32,21,5,87,64,23,5,466,1424,4
8,55,35,20,5,79,60,19,5,466,1424,4
9,55,33,22,5,80,63,17,5,466,1424,4
10,60,36,24,5,84,63,21,5,466,1424,4
1,98,79,19,5,90,75,15,5,146,2614,4
2,101,85,16,5,94,78,16,5,146,2614,4
3,119,100,19,5,92,76,16,5,146,2614,4
4,119,98,21,5,96,77,19,5,146,2614,4
5,121,96,25,5,92,77,15,5,146,2614,4
6,113,95,18,5,89,74,15,5,146,2614,4
7,89,73,16,5,89,75,14,5,146,2614,4
8,105,82,23,5,97,75,22,5,146,2614,4
9,99,86,13,5,94,78,16,5,146,2614,4
10,114,94,20,5,91,77,14,5,146,2614,4
1,98,79,19,5,90,75,15,5,254,101,4
2,101,85,16,5,94,78,16,5,254,101,4
3,119,100,19,5,92,76,16,5,254,101,4
4,119,98,21,5,96,77,19,5,254,101,4
5,121,96,25,5,92,77,15,5,254,101,4
6,113,95,18,5,89,74,15,5,254,101,4
7,89,73,16,5,89,75,14,5,254,101,4
8,105,82,23,5,97,75,22,5,254,101,4
9,99,86,13,5,94,78,16,5,254,101,4
10,114,94,20,5,91,77,14,5,254,101,4
1,50,39,11,5,75,60,15,5,362,2285,4
2,70,49,21,5,82,64,18,5,362,2285,4
3,69,45,24,5,78,63,15,5,362,2285,4
4,80,55,25,5,89,70,19,5,362,2285,4
5,59,37,22,5,61,49,12,5,362,2285,4
6,63,40,23,5,75,59,16,5,362,2285,4
7,65,46,19,5,79,62,17,5,362,2285,4
8,58,41,17,5,65,55,10,5,362,2285,4
9,64,40,24,5,72,51,21,5,362,2285,4
10,64,44,20,5,74,54,20,5,362,2285,4
1,98,79,19,5,90,75,15,5,28,3303,4
2,101,85,16,5,94,78,16,5,28,3303,4
3,119,100,19,5,92,76,16,5,28,3303,4
4,119,98,21,5,96,77,19,5,28,3303,4
5,121,96,25,5,92,77,15,5,28,3303,4
6,113,95,18,5,89,74,15,5,28,3303,4
7,89,73,16,5,89,75,14,5,28,3303,4
8,105,82,23,5,97,75,22,5,28,3303,4
9,99,86,13,5,94,78,16,5,28,3303,4
10,114,94,20,5,91,77,14,5,28,3303,4
1,98,79,19,5,90,75,15,5,82,993,4
2,101,85,16,5,94,78,16,5,82,993,4
3,119,100,19,5,92,76,16,5,82,993,4
4,119,98,21,5,96,77,19,5,82,993,4
5,121,96,25,5,92,77,15,5,82,993,4
6,113,95,18,5,89,74,15,5,82,993,4
7,89,73,16,5,89,75,14,5,82,993,4
8,105,82,23,5,97,75,22,5,82,993,4
9,99,86,13,5,94,78,16,5,82,993,4
10,114,94,20,5,91,77,14,5,82,993,4
1,50,36,14,5,70,54,16,5,421,324,4
2,60,38,22,5,98,73,25,5,421,324,4
3,62,40,22,5,69,60,9,5,421,324,4
4,55,35,20,5,76,57,19,5,421,324,4
5,63,38,25,5,60,51,9,5,421,324,4
6,59,37,22,5,79,59,20,5,421,324,4
7,49,30,19,5,79,58,21,5,421,324,4
8,49,31,18,5,71,56,15,5,421,324,4
9,54,34,20,5,69,54,15,5,421,324,4
10,48,33,15,5,80,62,18,5,421,324,4
1,98,79,19,5,90,75,15,5,128,3770,4
2,101,85,16,5,94,78,16,5,128,3770,4
3,119,100,19,5,92,76,16,5,128,3770,4
4,119,98,21,5,96,77,19,5,128,3770,4
5,121,96,25,5,92,77,15,5,128,3770,4
6,113,95,18,5,89,74,15,5,128,3770,4
7,89,73,16,5,89,75,14,5,128,3770,4
8,105,82,23,5,97,75,22,5,128,3770,4
9,99,86,13,5,94,78,16,5,128,3770,4
10,114,94,20,5,91,77,14,5,128,3770,4
1,92,78,14,5,88,75,13,5,258,1991,4
2,119,96,23,5,93,75,18,5,258,1991,4
3,114,99,15,5,94,74,20,5,258,1991,4
4,118,100,18,5,94,77,17,5,258,1991,4
5,122,97,25,5,94,77,17,5,258,1991,4
6,122,99,23,5,90,72,18,5,258,1991,4
7,104,82,22,5,92,75,17,5,258,1991,4
8,85,69,16,5,93,77,16,5,258,1991,4
9,104,84,20,5,87,77,10,5,258,1991,4
10,109,94,15,5,93,77,16,5,258,1991,4
1,68,51,17,5,85,67,18,5,365,387,4
2,64,45,19,5,89,70,19,5,365,387,4
3,68,42,26,5,80,65,15,5,365,387,4
4,59,38,21,5,79,64,15,5,365,387,4
5,62,41,21,5,80,65,15,5,365,387,4
6,61,37,24,5,72,55,17,5,365,387,4
7,61,38,23,5,52,42,10,5,365,387,4
8,52,36,16,5,70,51,19,5,365,387,4
9,63,44,19,5,54,42,12,5,365,387,4
10,62,43,19,5,86,64,22,5,365,387,4
1,57,37,20,5,83,61,22,5,453,2389,4
2,52,37,15,5,84,65,19,5,453,2389,4
3,69,42,27,5,72,59,13,5,453,2389,4
4,50,33,17,5,69,55,14,5,453,2389,4
5,59,37,22,5,61,53,8,5,453,2389,4
6,55,36,19,5,83,59,24,5,453,2389,4
7,50,31,19,5,72,57,15,5,453,2389,4
8,52,31,21,5,68,55,13,5,453,2389,4
9,56,33,23,5,67,52,15,5,453,2389,4
10,45,29,16,5,85,64,21,5,453,2389,4
1,52,34,18,5,61,48,13,5,447,1723,4
2,68,40,28,5,74,59,15,5,447,1723,4
3,56,37,19,5,68,54,14,5,447,1723,4
4,50,38,12,5,77,62,15,5,447,1723,4
5,47,32,15,5,74,62,12,5,447,1723,4
6,62,40,22,5,64,53,11,5,447,1723,4
7,48,31,17,5,87,65,22,5,447,1723,4
8,55,33,22,5,85,67,18,5,447,1723,4
9,55,32,23,5,83,64,19,5,447,1723,4
10,57,33,24,5,92,68,24,5,447,1723,4
1,98,79,19,5,90,75,15,5,167,2237,4
2,101,85,16,5,94,78,16,5,167,2237,4
3,119,100,19,5,92,76,16,5,167,2237,4
4,119,98,21,5,96,77,19,5,167,2237,4
5,121,96,25,5,92,77,15,5,167,2237,4
6,113,95,18,5,89,74,15,5,167,2237,4
7,89,73,16,5,89,75,14,5,167,2237,4
8,105,82,23,5,97,75,22,5,167,2237,4
9,99,86,13,5,94,78,16,5,167,2237,4
10,114,94,20,5,91,77,14,5,167,2237,4
1,64,48,16,5,80,62,18,5,392,2480,4
2,78,56,22,5,74,57,17,5,392,2480,4
3,71,47,24,5,64,53,11,5,392,2480,4
4,63,43,20,5,80,59,21,5,392,2480,4
5,48,34,14,5,87,67,20,5,392,2480,4
6,68,45,23,5,69,51,18,5,392,2480,4
7,58,37,21,5,64,51,13,5,392,2480,4
8,59,39,20,5,79,63,16,5,392,2480,4
9,51,36,15,5,70,60,10,5,392,2480,4
10,69,44,25,5,74,56,18,5,392,2480,4
1,52,37,15,5,59,47,12,5,449,1006,4
2,66,40,26,5,73,59,14,5,449,1006,4
3,55,37,18,5,67,54,13,5,449,1006,4
4,46,34,12,5,74,60,14,5,449,1006,4
5,48,32,16,5,71,60,11,5,449,1006,4
6,59,39,20,5,62,51,11,5,449,1006,4
7,53,32,21,5,93,69,24,5,449,1006,4
8,55,32,23,5,84,63,21,5,449,1006,4
9,59,35,24,5,94,69,25,5,449,1006,4
10,60,36,24,5,79,61,18,5,449,1006,4
1,98,79,19,5,90,75,15,5,187,1806,4
2,101,85,16,5,94,78,16,5,187,1806,4
3,119,100,19,5,92,76,16,5,187,1806,4
4,119,98,21,5,96,77,19,5,187,1806,4
5,121,96,25,5,92,77,15,5,187,1806,4
6,113,95,18,5,89,74,15,5,187,1806,4
7,89,73,16,5,89,75,14,5,187,1806,4
8,105,82,23,5,97,75,22,5,187,1806,4
9,99,86,13,5,94,78,16,5,187,1806,4
10,114,94,20,5,91,77,14,5,187,1806,4
1,64,45,19,5,87,66,21,5,490,2957,4
2,71,47,24,5,75,61,14,5,490,2957,4
3,68,45,23,5,68,54,14,5,490,2957,4
4,78,52,26,5,80,63,17,5,490,2957,4
5,45,35,10,5,78,61,17,5,490,2957,4
6,49,36,13,5,91,67,24,5,490,2957,4
7,65,51,14,5,75,61,14,5,490,2957,4
8,65,49,16,5,67,51,16,5,490,2957,4
9,81,50,31,5,63,51,12,5,490,2957,4
10,82,56,26,5,63,48,15,5,490,2957,4
1,65,49,16,5,78,65,13,5,328,1409,4
2,66,44,22,5,85,66,19,5,328,1409,4
3,66,43,23,5,79,64,15,5,328,1409,4
4,64,39,25,5,82,65,17,5,328,1409,4
5,59,40,19,5,67,53,14,5,328,1409,4
6,50,34,16,5,62,42,20,5,328,1409,4
7,61,38,23,5,72,53,19,5,328,1409,4
8,49,34,15,5,63,52,11,5,328,1409,4
9,56,38,18,5,68,55,13,5,328,1409,4
10,66,46,20,5,85,63,22,5,328,1409,4
1,63,45,18,5,75,61,14,5,371,264,4
2,63,45,18,5,79,65,14,5,371,264,4
3,59,40,19,5,82,70,12,5,371,264,4
4,60,38,22,5,89,68,21,5,371,264,4
5,66,40,26,5,78,58,20,5,371,264,4
6,65,38,27,5,65,47,18,5,371,264,4
7,57,37,20,5,68,52,16,5,371,264,4
8,57,41,16,5,69,58,11,5,371,264,4
9,54,39,15,5,58,48,10,5,371,264,4
10,60,41,19,5,77,50,27,5,371,264,4
1,101,82,19,5,92,75,17,5,179,2721,4
2,109,89,20,5,93,74,19,5,179,2721,4
3,115,97,18,5,94,74,20,5,179,2721,4
4,124,106,18,5,93,79,14,5,179,2721,4
5,119,91,28,5,92,76,16,5,179,2721,4
6,110,94,16,5,91,78,13,5,179,2721,4
7,88,72,16,5,91,75,16,5,179,2721,4
8,84,68,16,5,95,79,16,5,179,2721,4
9,107,90,17,5,89,76,13,5,179,2721,4
10,115,93,22,5,94,76,18,5,179,2721,4
1,98,79,19,5,90,75,15,5,146,1727,4
2,101,85,16,5,94,78,16,5,146,1727,4
3,119,100,19,5,92,76,16,5,146,1727,4
4,119,98,21,5,96,77,19,5,146,1727,4
5,121,96,25,5,92,77,15,5,146,1727,4
6,113,95,18,5,89,74,15,5,146,1727,4
7,89,73,16,5,89,75,14,5,146,1727,4
8,105,82,23,5,97,75,22,5,146,1727,4
9,99,86,13,5,94,78,16,5,146,1727,4
10,114,94,20,5,91,77,14,5,146,1727,4
1,54,37,17,5,76,58,18,5,440,1477,4
2,53,37,16,5,88,69,19,5,440,1477,4
3,60,38,22,5,72,62,10,5,440,1477,4
4,57,37,20,5,73,57,16,5,440,1477,4
5,67,41,26,5,72,57,15,5,440,1477,4
6,60,35,25,5,86,65,21,5,440,1477,4
7,52,32,20,5,72,55,17,5,440,1477,4
8,46,30,16,5,68,52,16,5,440,1477,4
9,54,32,22,5,74,57,17,5,440,1477,4
10,49,32,17,5,70,56,14,5,440,1477,4
1,58,40,18,5,77,60,17,5,438,2771,4
2,53,33,20,5,75,56,19,5,438,2771,4
3,66,41,25,5,60,48,12,5,438,2771,4
4,49,35,14,5,77,60,17,5,438,2771,4
5,55,34,21,5,69,56,13,5,438,2771,4
6,55,36,19,5,80,60,20,5,438,2771,4
7,43,33,10,5,90,70,20,5,438,2771,4
8,62,38,24,5,70,56,14,5,438,2771,4
9,63,37,26,5,63,54,9,5,438,2771,4
10,62,37,25,5,83,62,21,5,438,2771,4
1,71,50,21,5,76,58,18,5,451,3660,4
2,59,41,18,5,77,61,16,5,451,3660,4
3,66,42,24,5,75,56,19,5,451,3660,4
4,62,39,23,5,78,61,17,5,451,3660,4
5,48,33,15,5,78,61,17,5,451,3660,4
6,56,33,23,5,80,60,20,5,451,3660,4
7,60,38,22,5,71,57,14,5,451,3660,4
8,57,39,18,5,71,59,12,5,451,3660,4
9,54,36,18,5,74,57,17,5,451,3660,4
10,56,37,19,5,56,44,12,5,451,3660,4
1,98,79,19,5,90,75,15,5,202,1819,4
2,101,85,16,5,94,78,16,5,202,1819,4
3,119,100,19,5,92,76,16,5,202,1819,4
4,119,98,21,5,96,77,19,5,202,1819,4
5,121,96,25,5,92,77,15,5,202,1819,4
6,113,95,18,5,89,74,15,5,202,1819,4
7,89,73,16,5,89,75,14,5,202,1819,4
8,105,82,23,5,97,75,22,5,202,1819,4
9,99,86,13,5,94,78,16,5,202,1819,4
10,114,94,20,5,91,77,14,5,202,1819,4
1,91,79,12,5,89,74,15,5,177,3286,4
2,120,96,24,5,93,77,16,5,177,3286,4
3,121,104,17,5,93,75,18,5,177,3286,4
4,130,107,23,5,101,78,23,5,177,3286,4
5,117,92,25,5,93,73,20,5,177,3286,4
6,110,92,18,5,89,75,14,5,177,3286,4
7,90,72,18,5,87,74,13,5,177,3286,4
8,89,72,17,5,93,77,16,5,177,3286,4
9,104,85,19,5,88,77,11,5,177,3286,4
10,110,93,17,5,92,76,16,5,177,3286,4
1,59,38,21,5,74,53,21,5,494,1414,4
2,64,40,24,5,93,72,21,5,494,1414,4
3,57,38,19,5,69,60,9,5,494,1414,4
4,56,37,19,5,71,58,13,5,494,1414,4
5,60,37,23,5,68,56,12,5,494,1414,4
6,52,34,18,5,81,60,21,5,494,1414,4
7,59,32,27,5,80,61,19,5,494,1414,4
8,42,28,14,5,69,54,15,5,494,1414,4
9,51,32,19,5,71,53,18,5,494,1414,4
10,49,33,16,5,70,56,14,5,494,1414,4
1,96,73,23,5,103,85,18,5,247,3683,4
2,92,72,20,5,97,85,12,5,247,3683,4
3,92,76,16,5,102,84,18,5,247,3683,4
4,103,76,27,5,98,80,18,5,247,3683,4
5,102,73,29,5,98,79,19,5,247,3683,4
6,98,69,29,5,102,78,24,5,247,3683,4
7,108,70,38,5,102,82,20,5,247,3683,4
8,103,71,32,5,100,82,18,5,247,3683,4
9,106,74,32,5,102,79,23,5,247,3683,4
10,90,74,16,5,98,77,21,5,247,3683,4
1,96,71,25,5,100,82,18,5,269,1151,4
2,94,70,24,5,104,80,24,5,269,1151,4
3,94,70,24,5,101,80,21,5,269,1151,4
4,95,69,26,5,102,81,21,5,269,1151,4
5,94,68,26,5,105,84,21,5,269,1151,4
6,98,68,30,5,104,82,22,5,269,1151,4
7,96,69,27,5,98,81,17,5,269,1151,4
8,95,66,29,5,102,83,19,5,269,1151,4
9,99,71,28,5,100,87,13,5,269,1151,4
10,100,69,31,5,98,84,14,5,269,1151,4
1,98,79,19,5,90,75,15,5,235,2743,4
2,101,85,16,5,94,78,16,5,235,2743,4
3,119,100,19,5,92,76,16,5,235,2743,4
4,119,98,21,5,96,77,19,5,235,2743,4
5,121,96,25,5,92,77,15,5,235,2743,4
6,113,95,18,5,89,74,15,5,235,2743,4
7,89,73,16,5,89,75,14,5,235,2743,4
8,105,82,23,5,97,75,22,5,235,2743,4
9,99,86,13,5,94,78,16,5,235,2743,4
10,114,94,20,5,91,77,14,5,235,2743,4
1,98,79,19,5,90,75,15,5,19,2744,4
2,101,85,16,5,94,78,16,5,19,2744,4
3,119,100,19,5,92,76,16,5,19,2744,4
4,119,98,21,5,96,77,19,5,19,2744,4
5,121,96,25,5,92,77,15,5,19,2744,4
6,113,95,18,5,89,74,15,5,19,2744,4
7,89,73,16,5,89,75,14,5,19,2744,4
8,105,82,23,5,97,75,22,5,19,2744,4
9,99,86,13,5,94,78,16,5,19,2744,4
10,114,94,20,5,91,77,14,5,19,2744,4
1,98,79,19,5,90,75,15,5,11,2996,4
2,101,85,16,5,94,78,16,5,11,2996,4
3,119,100,19,5,92,76,16,5,11,2996,4
4,119,98,21,5,96,77,19,5,11,2996,4
5,121,96,25,5,92,77,15,5,11,2996,4
6,113,95,18,5,89,74,15,5,11,2996,4
7,89,73,16,5,89,75,14,5,11,2996,4
8,105,82,23,5,97,75,22,5,11,2996,4
9,99,86,13,5,94,78,16,5,11,2996,4
10,114,94,20,5,91,77,14,5,11,2996,4
1,62,42,20,5,84,65,19,5,410,94,4
2,59,37,22,5,80,67,13,5,410,94,4
3,57,37,20,5,79,63,16,5,410,94,4
4,53,36,17,5,74,60,14,5,410,94,4
5,49,32,17,5,65,49,16,5,410,94,4
6,63,41,22,5,81,62,19,5,410,94,4
7,48,31,17,5,69,56,13,5,410,94,4
8,46,30,16,5,56,43,13,5,410,94,4
9,57,31,26,5,73,55,18,5,410,94,4
10,61,38,23,5,77,56,21,5,410,94,4
1,56,41,15,5,85,65,20,5,402,1259,4
2,69,48,21,5,72,54,18,5,402,1259,4
3,82,50,32,5,88,64,24,5,402,1259,4
4,66,45,21,5,79,63,16,5,402,1259,4
5,56,37,19,5,73,57,16,5,402,1259,4
6,63,42,21,5,71,59,12,5,402,1259,4
7,51,37,14,5,68,56,12,5,402,1259,4
8,58,42,16,5,73,60,13,5,402,1259,4
9,64,42,22,5,52,40,12,5,402,1259,4
10,56,38,18,5,67,47,20,5,402,1259,4
1,52,34,18,5,61,48,13,5,486,27,4
2,68,40,28,5,74,59,15,5,486,27,4
3,56,37,19,5,68,54,14,5,486,27,4
4,50,38,12,5,77,62,15,5,486,27,4
5,47,32,15,5,74,62,12,5,486,27,4
6,62,40,22,5,64,53,11,5,486,27,4
7,48,31,17,5,87,65,22,5,486,27,4
8,55,33,22,5,85,67,18,5,486,27,4
9,55,32,23,5,83,64,19,5,486,27,4
10,57,33,24,5,92,68,24,5,486,27,4
1,95,73,22,5,105,84,21,5,239,517,4
2,94,73,21,5,103,85,18,5,239,517,4
3,94,74,20,5,102,85,17,5,239,517,4
4,104,75,29,5,99,86,13,5,239,517,4
5,99,71,28,5,99,83,16,5,239,517,4
6,98,67,31,5,100,80,20,5,239,517,4
7,104,72,32,5,104,84,20,5,239,517,4
8,96,67,29,5,103,85,18,5,239,517,4
9,105,75,30,5,102,78,24,5,239,517,4
10,93,73,20,5,100,77,23,5,239,517,4
1,53,37,16,5,62,52,10,5,425,2605,4
2,63,38,25,5,79,60,19,5,425,2605,4
3,55,37,18,5,62,52,10,5,425,2605,4
4,46,36,10,5,89,67,22,5,425,2605,4
5,54,35,19,5,70,57,13,5,425,2605,4
6,61,39,22,5,60,51,9,5,425,2605,4
7,57,32,25,5,86,62,24,5,425,2605,4
8,48,29,19,5,82,64,18,5,425,2605,4
9,58,35,23,5,87,67,20,5,425,2605,4
10,56,33,23,5,80,62,18,5,425,2605,4
1,65,49,16,5,78,65,13,5,328,1223,4
2,66,44,22,5,85,66,19,5,328,1223,4
3,66,43,23,5,79,64,15,5,328,1223,4
4,64,39,25,5,82,65,17,5,328,1223,4
5,59,40,19,5,67,53,14,5,328,1223,4
6,50,34,16,5,62,42,20,5,328,1223,4
7,61,38,23,5,72,53,19,5,328,1223,4
8,49,34,15,5,63,52,11,5,328,1223,4
9,56,38,18,5,68,55,13,5,328,1223,4
10,66,46,20,5,85,63,22,5,328,1223,4
1,98,79,19,5,90,75,15,5,152,2863,4
2,101,85,16,5,94,78,16,5,152,2863,4
3,119,100,19,5,92,76,16,5,152,2863,4
4,119,98,21,5,96,77,19,5,152,2863,4
5,121,96,25,5,92,77,15,5,152,2863,4
6,113,95,18,5,89,74,15,5,152,2863,4
7,89,73,16,5,89,75,14,5,152,2863,4
8,105,82,23,5,97,75,22,5,152,2863,4
9,99,86,13,5,94,78,16,5,152,2863,4
10,114,94,20,5,91,77,14,5,152,2863,4
1,76,47,29,5,93,73,20,5,502,465,4
2,69,44,25,5,84,69,15,5,502,465,4
3,64,37,27,5,98,72,26,5,502,465,4
4,66,38,28,5,91,68,23,5,502,465,4
5,65,36,29,5,92,67,25,5,502,465,4
6,55,32,23,5,80,62,18,5,502,465,4
7,68,39,29,5,84,59,25,5,502,465,4
8,61,38,23,5,89,68,21,5,502,465,4
9,84,53,31,5,80,58,22,5,502,465,4
10,67,42,25,5,99,69,30,5,502,465,4
1,57,38,19,5,71,54,17,5,391,321,4
2,66,40,26,5,75,60,15,5,391,321,4
3,57,37,20,5,68,56,12,5,391,321,4
4,42,34,8,5,73,59,14,5,391,321,4
5,47,31,16,5,72,61,11,5,391,321,4
6,54,38,16,5,66,53,13,5,391,321,4
7,55,34,21,5,82,60,22,5,391,321,4
8,57,33,24,5,79,60,19,5,391,321,4
9,54,33,21,5,79,60,19,5,391,321,4
10,64,36,28,5,86,65,21,5,391,321,4
1,56,39,17,5,78,64,14,5,465,3693,4
2,60,41,19,5,72,56,16,5,465,3693,4
3,67,42,25,5,77,62,15,5,465,3693,4
4,61,38,23,5,71,54,17,5,465,3693,4
5,46,30,16,5,70,53,17,5,465,3693,4
6,73,42,31,5,69,53,16,5,465,3693,4
7,48,33,15,5,54,41,13,5,465,3693,4
8,56,35,21,5,87,69,18,5,465,3693,4
9,46,32,14,5,73,58,15,5,465,3693,4
10,54,35,19,5,86,65,21,5,465,3693,4
1,52,37,15,5,59,47,12,5,461,3639,4
2,66,40,26,5,73,59,14,5,461,3639,4
3,55,37,18,5,67,54,13,5,461,3639,4
4,46,34,12,5,74,60,14,5,461,3639,4
5,48,32,16,5,71,60,11,5,461,3639,4
6,59,39,20,5,62,51,11,5,461,3639,4
7,53,32,21,5,93,69,24,5,461,3639,4
8,55,32,23,5,84,63,21,5,461,3639,4
9,59,35,24,5,94,69,25,5,461,3639,4
10,60,36,24,5,79,61,18,5,461,3639,4
1,98,79,19,5,90,75,15,5,28,1344,4
2,101,85,16,5,94,78,16,5,28,1344,4
3,119,100,19,5,92,76,16,5,28,1344,4
4,119,98,21,5,96,77,19,5,28,1344,4
5,121,96,25,5,92,77,15,5,28,1344,4
6,113,95,18,5,89,74,15,5,28,1344,4
7,89,73,16,5,89,75,14,5,28,1344,4
8,105,82,23,5,97,75,22,5,28,1344,4
9,99,86,13,5,94,78,16,5,28,1344,4
10,114,94,20,5,91,77,14,5,28,1344,4
1,56,40,16,5,88,70,18,5,406,3249,4
2,70,40,30,5,77,63,14,5,406,3249,4
3,53,37,16,5,62,46,16,5,406,3249,4
4,46,32,14,5,79,59,20,5,406,3249,4
5,60,34,26,5,67,55,12,5,406,3249,4
6,51,32,19,5,72,52,20,5,406,3249,4
7,52,35,17,5,67,54,13,5,406,3249,4
8,60,42,18,5,72,55,17,5,406,3249,4
9,59,37,22,5,78,63,15,5,406,3249,4
10,63,38,25,5,77,60,17,5,406,3249,4
1,91,79,12,5,89,74,15,5,230,3742,4
2,120,96,24,5,93,77,16,5,230,3742,4
3,121,104,17,5,93,75,18,5,230,3742,4
4,130,107,23,5,101,78,23,5,230,3742,4
5,117,92,25,5,93,73,20,5,230,3742,4
6,110,92,18,5,89,75,14,5,230,3742,4
7,90,72,18,5,87,74,13,5,230,3742,4
8,89,72,17,5,93,77,16,5,230,3742,4
9,104,85,19,5,88,77,11,5,230,3742,4
10,110,93,17,5,92,76,16,5,230,3742,4
1,62,45,17,5,68,60,8,5,375,64,4
2,73,51,22,5,84,67,17,5,375,64,4
3,68,46,22,5,86,67,19,5,375,64,4
4,67,42,25,5,83,61,22,5,375,64,4
5,46,32,14,5,61,46,15,5,375,64,4
6,68,42,26,5,64,47,17,5,375,64,4
7,52,37,15,5,57,47,10,5,375,64,4
8,62,41,21,5,94,76,18,5,375,64,4
9,59,38,21,5,80,59,21,5,375,64,4
10,62,45,17,5,75,58,17,5,375,64,4
1,98,79,19,5,90,75,15,5,48,1719,4
2,101,85,16,5,94,78,16,5,48,1719,4
3,119,100,19,5,92,76,16,5,48,1719,4
4,119,98,21,5,96,77,19,5,48,1719,4
5,121,96,25,5,92,77,15,5,48,1719,4
6,113,95,18,5,89,74,15,5,48,1719,4
7,89,73,16,5,89,75,14,5,48,1719,4
8,105,82,23,5,97,75,22,5,48,1719,4
9,99,86,13,5,94,78,16,5,48,1719,4
10,114,94,20,5,91,77,14,5,48,1719,4
1,72,47,25,5,83,65,18,5,306,3714,4
2,71,51,20,5,76,59,17,5,306,3714,4
3,63,41,22,5,60,46,14,5,306,3714,4
4,67,43,24,5,64,49,15,5,306,3714,4
5,63,43,20,5,76,56,20,5,306,3714,4
6,68,42,26,5,71,57,14,5,306,3714,4
7,55,35,20,5,79,59,20,5,306,3714,4
8,52,37,15,5,82,67,15,5,306,3714,4
9,49,38,11,5,78,63,15,5,306,3714,4
10,60,42,18,5,69,54,15,5,306,3714,4
1,98,79,19,5,90,75,15,5,225,1046,4
2,101,85,16,5,94,78,16,5,225,1046,4
3,119,100,19,5,92,76,16,5,225,1046,4
4,119,98,21,5,96,77,19,5,225,1046,4
5,121,96,25,5,92,77,15,5,225,1046,4
6,113,95,18,5,89,74,15,5,225,1046,4
7,89,73,16,5,89,75,14,5,225,1046,4
8,105,82,23,5,97,75,22,5,225,1046,4
9,99,86,13,5,94,78,16,5,225,1046,4
10,114,94,20,5,91,77,14,5,225,1046,4
1,76,47,29,5,93,73,20,5,502,1421,4
2,69,44,25,5,84,69,15,5,502,1421,4
3,64,37,27,5,98,72,26,5,502,1421,4
4,66,38,28,5,91,68,23,5,502,1421,4
5,65,36,29,5,92,67,25,5,502,1421,4
6,55,32,23,5,80,62,18,5,502,1421,4
7,68,39,29,5,84,59,25,5,502,1421,4
8,61,38,23,5,89,68,21,5,502,1421,4
9,84,53,31,5,80,58,22,5,502,1421,4
10,67,42,25,5,99,69,30,5,502,1421,4
1,98,79,19,5,90,75,15,5,154,384,4
2,101,85,16,5,94,78,16,5,154,384,4
3,119,100,19,5,92,76,16,5,154,384,4
4,119,98,21,5,96,77,19,5,154,384,4
5,121,96,25,5,92,77,15,5,154,384,4
6,113,95,18,5,89,74,15,5,154,384,4
7,89,73,16,5,89,75,14,5,154,384,4
8,105,82,23,5,97,75,22,5,154,384,4
9,99,86,13,5,94,78,16,5,154,384,4
10,114,94,20,5,91,77,14,5,154,384,4
1,61,45,16,5,90,69,21,5,387,2997,4
2,73,54,19,5,58,46,12,5,387,2997,4
3,80,52,28,5,72,60,12,5,387,2997,4
4,81,53,28,5,92,72,20,5,387,2997,4
5,54,38,16,5,80,63,17,5,387,2997,4
6,54,38,16,5,54,43,11,5,387,2997,4
7,55,37,18,5,69,55,14,5,387,2997,4
8,56,39,17,5,80,63,17,5,387,2997,4
9,52,36,16,5,62,46,16,5,387,2997,4
10,67,42,25,5,69,47,22,5,387,2997,4
1,98,79,19,5,90,75,15,5,90,2551,4
2,101,85,16,5,94,78,16,5,90,2551,4
3,119,100,19,5,92,76,16,5,90,2551,4
4,119,98,21,5,96,77,19,5,90,2551,4
5,121,96,25,5,92,77,15,5,90,2551,4
6,113,95,18,5,89,74,15,5,90,2551,4
7,89,73,16,5,89,75,14,5,90,2551,4
8,105,82,23,5,97,75,22,5,90,2551,4
9,99,86,13,5,94,78,16,5,90,2551,4
10,114,94,20,5,91,77,14,5,90,2551,4
1,71,50,21,5,76,58,18,5,451,2049,4
2,59,41,18,5,77,61,16,5,451,2049,4
3,66,42,24,5,75,56,19,5,451,2049,4
4,62,39,23,5,78,61,17,5,451,2049,4
5,48,33,15,5,78,61,17,5,451,2049,4
6,56,33,23,5,80,60,20,5,451,2049,4
7,60,38,22,5,71,57,14,5,451,2049,4
8,57,39,18,5,71,59,12,5,451,2049,4
9,54,36,18,5,74,57,17,5,451,2049,4
10,56,37,19,5,56,44,12,5,451,2049,4
1,98,79,19,5,90,75,15,5,137,3450,4
2,101,85,16,5,94,78,16,5,137,3450,4
3,119,100,19,5,92,76,16,5,137,3450,4
4,119,98,21,5,96,77,19,5,137,3450,4
5,121,96,25,5,92,77,15,5,137,3450,4
6,113,95,18,5,89,74,15,5,137,3450,4
7,89,73,16,5,89,75,14,5,137,3450,4
8,105,82,23,5,97,75,22,5,137,3450,4
9,99,86,13,5,94,78,16,5,137,3450,4
10,114,94,20,5,91,77,14,5,137,3450,4
1,98,79,19,5,90,75,15,5,198,3049,4
2,101,85,16,5,94,78,16,5,198,3049,4
3,119,100,19,5,92,76,16,5,198,3049,4
4,119,98,21,5,96,77,19,5,198,3049,4
5,121,96,25,5,92,77,15,5,198,3049,4
6,113,95,18,5,89,74,15,5,198,3049,4
7,89,73,16,5,89,75,14,5,198,3049,4
8,105,82,23,5,97,75,22,5,198,3049,4
9,99,86,13,5,94,78,16,5,198,3049,4
10,114,94,20,5,91,77,14,5,198,3049,4
1,98,79,19,5,90,75,15,5,26,3114,4
2,101,85,16,5,94,78,16,5,26,3114,4
3,119,100,19,5,92,76,16,5,26,3114,4
4,119,98,21,5,96,77,19,5,26,3114,4
5,121,96,25,5,92,77,15,5,26,3114,4
6,113,95,18,5,89,74,15,5,26,3114,4
7,89,73,16,5,89,75,14,5,26,3114,4
8,105,82,23,5,97,75,22,5,26,3114,4
9,99,86,13,5,94,78,16,5,26,3114,4
10,114,94,20,5,91,77,14,5,26,3114,4
1,98,79,19,5,90,75,15,5,161,1949,4
2,101,85,16,5,94,78,16,5,161,1949,4
3,119,100,19,5,92,76,16,5,161,1949,4
4,119,98,21,5,96,77,19,5,161,1949,4
5,121,96,25,5,92,77,15,5,161,1949,4
6,113,95,18,5,89,74,15,5,161,1949,4
7,89,73,16,5,89,75,14,5,161,1949,4
8,105,82,23,5,97,75,22,5,161,1949,4
9,99,86,13,5,94,78,16,5,161,1949,4
10,114,94,20,5,91,77,14,5,161,1949,4
1,98,79,19,5,90,75,15,5,92,1326,4
2,101,85,16,5,94,78,16,5,92,1326,4
3,119,100,19,5,92,76,16,5,92,1326,4
4,119,98,21,5,96,77,19,5,92,1326,4
5,121,96,25,5,92,77,15,5,92,1326,4
6,113,95,18,5,89,74,15,5,92,1326,4
7,89,73,16,5,89,75,14,5,92,1326,4
8,105,82,23,5,97,75,22,5,92,1326,4
9,99,86,13,5,94,78,16,5,92,1326,4
10,114,94,20,5,91,77,14,5,92,1326,4
1,79,68,11,5,92,79,13,5,274,1818,4
2,113,89,24,5,94,76,18,5,274,1818,4
3,106,82,24,5,95,75,20,5,274,1818,4
4,125,102,23,5,91,76,15,5,274,1818,4
5,101,78,23,5,94,77,17,5,274,1818,4
6,102,83,19,5,89,73,16,5,274,1818,4
7,103,88,15,5,91,76,15,5,274,1818,4
8,110,92,18,5,93,76,17,5,274,1818,4
9,119,99,20,5,91,75,16,5,274,1818,4
10,107,94,13,5,94,79,15,5,274,1818,4
1,98,79,19,5,90,75,15,5,15,977,4
2,101,85,16,5,94,78,16,5,15,977,4
3,119,100,19,5,92,76,16,5,15,977,4
4,119,98,21,5,96,77,19,5,15,977,4
5,121,96,25,5,92,77,15,5,15,977,4
6,113,95,18,5,89,74,15,5,15,977,4
7,89,73,16,5,89,75,14,5,15,977,4
8,105,82,23,5,97,75,22,5,15,977,4
9,99,86,13,5,94,78,16,5,15,977,4
10,114,94,20,5,91,77,14,5,15,977,4
1,67,44,23,5,92,72,20,5,478,1179,4
2,77,46,31,5,88,69,19,5,478,1179,4
3,72,43,29,5,97,70,27,5,478,1179,4
4,65,41,24,5,98,69,29,5,478,1179,4
5,62,34,28,5,77,62,15,5,478,1179,4
6,64,38,26,5,69,50,19,5,478,1179,4
7,63,40,23,5,79,52,27,5,478,1179,4
8,61,42,19,5,94,71,23,5,478,1179,4
9,60,35,25,5,99,74,25,5,478,1179,4
10,71,42,29,5,89,68,21,5,478,1179,4
1,70,39,31,5,88,69,19,5,480,3496,4
2,57,36,21,5,96,71,25,5,480,3496,4
3,68,38,30,5,96,66,30,5,480,3496,4
4,64,39,25,5,85,65,20,5,480,3496,4
5,69,36,33,5,88,65,23,5,480,3496,4
6,66,43,23,5,82,61,21,5,480,3496,4
7,73,44,29,5,74,55,19,5,480,3496,4
8,66,45,21,5,88,64,24,5,480,3496,4
9,74,46,28,5,89,67,22,5,480,3496,4
10,61,39,22,5,91,69,22,5,480,3496,4
1,98,79,19,5,90,75,15,5,10,3389,4
2,101,85,16,5,94,78,16,5,10,3389,4
3,119,100,19,5,92,76,16,5,10,3389,4
4,119,98,21,5,96,77,19,5,10,3389,4
5,121,96,25,5,92,77,15,5,10,3389,4
6,113,95,18,5,89,74,15,5,10,3389,4
7,89,73,16,5,89,75,14,5,10,3389,4
8,105,82,23,5,97,75,22,5,10,3389,4
9,99,86,13,5,94,78,16,5,10,3389,4
10,114,94,20,5,91,77,14,5,10,3389,4
1,98,79,19,5,90,75,15,5,46,3162,4
2,101,85,16,5,94,78,16,5,46,3162,4
3,119,100,19,5,92,76,16,5,46,3162,4
4,119,98,21,5,96,77,19,5,46,3162,4
5,121,96,25,5,92,77,15,5,46,3162,4
6,113,95,18,5,89,74,15,5,46,3162,4
7,89,73,16,5,89,75,14,5,46,3162,4
8,105,82,23,5,97,75,22,5,46,3162,4
9,99,86,13,5,94,78,16,5,46,3162,4
10,114,94,20,5,91,77,14,5,46,3162,4
1,98,79,19,5,90,75,15,5,136,190,4
2,101,85,16,5,94,78,16,5,136,190,4
3,119,100,19,5,92,76,16,5,136,190,4
4,119,98,21,5,96,77,19,5,136,190,4
5,121,96,25,5,92,77,15,5,136,190,4
6,113,95,18,5,89,74,15,5,136,190,4
7,89,73,16,5,89,75,14,5,136,190,4
8,105,82,23,5,97,75,22,5,136,190,4
9,99,86,13,5,94,78,16,5,136,190,4
10,114,94,20,5,91,77,14,5,136,190,4
1,98,79,19,5,90,75,15,5,61,501,4
2,101,85,16,5,94,78,16,5,61,501,4
3,119,100,19,5,92,76,16,5,61,501,4
4,119,98,21,5,96,77,19,5,61,501,4
5,121,96,25,5,92,77,15,5,61,501,4
6,113,95,18,5,89,74,15,5,61,501,4
7,89,73,16,5,89,75,14,5,61,501,4
8,105,82,23,5,97,75,22,5,61,501,4
9,99,86,13,5,94,78,16,5,61,501,4
10,114,94,20,5,91,77,14,5,61,501,4
1,57,43,14,5,74,58,16,5,294,1047,4
2,56,45,11,5,81,63,18,5,294,1047,4
3,73,45,28,5,73,57,16,5,294,1047,4
4,73,46,27,5,91,70,21,5,294,1047,4
5,64,40,24,5,74,59,15,5,294,1047,4
6,64,41,23,5,71,59,12,5,294,1047,4
7,56,37,19,5,63,50,13,5,294,1047,4
8,58,41,17,5,70,51,19,5,294,1047,4
9,50,35,15,5,64,53,11,5,294,1047,4
10,64,45,19,5,80,58,22,5,294,1047,4
1,98,79,19,5,90,75,15,5,27,2878,4
2,101,85,16,5,94,78,16,5,27,2878,4
3,119,100,19,5,92,76,16,5,27,2878,4
4,119,98,21,5,96,77,19,5,27,2878,4
5,121,96,25,5,92,77,15,5,27,2878,4
6,113,95,18,5,89,74,15,5,27,2878,4
7,89,73,16,5,89,75,14,5,27,2878,4
8,105,82,23,5,97,75,22,5,27,2878,4
9,99,86,13,5,94,78,16,5,27,2878,4
10,114,94,20,5,91,77,14,5,27,2878,4
1,98,79,19,5,90,75,15,5,120,2603,4
2,101,85,16,5,94,78,16,5,120,2603,4
3,119,100,19,5,92,76,16,5,120,2603,4
4,119,98,21,5,96,77,19,5,120,2603,4
5,121,96,25,5,92,77,15,5,120,2603,4
6,113,95,18,5,89,74,15,5,120,2603,4
7,89,73,16,5,89,75,14,5,120,2603,4
8,105,82,23,5,97,75,22,5,120,2603,4
9,99,86,13,5,94,78,16,5,120,2603,4
10,114,94,20,5,91,77,14,5,120,2603,4
1,61,39,22,5,67,56,11,5,394,3651,4
2,59,37,22,5,71,55,16,5,394,3651,4
3,68,41,27,5,82,63,19,5,394,3651,4
4,50,36,14,5,84,64,20,5,394,3651,4
5,53,30,23,5,68,55,13,5,394,3651,4
6,58,39,19,5,73,60,13,5,394,3651,4
7,43,29,14,5,90,67,23,5,394,3651,4
8,58,32,26,5,70,55,15,5,394,3651,4
9,52,31,21,5,79,58,21,5,394,3651,4
10,49,34,15,5,54,42,12,5,394,3651,4
1,98,79,19,5,90,75,15,5,208,3669,4
2,101,85,16,5,94,78,16,5,208,3669,4
3,119,100,19,5,92,76,16,5,208,3669,4
4,119,98,21,5,96,77,19,5,208,3669,4
5,121,96,25,5,92,77,15,5,208,3669,4
6,113,95,18,5,89,74,15,5,208,3669,4
7,89,73,16,5,89,75,14,5,208,3669,4
8,105,82,23,5,97,75,22,5,208,3669,4
9,99,86,13,5,94,78,16,5,208,3669,4
10,114,94,20,5,91,77,14,5,208,3669,4
1,52,37,15,5,59,47,12,5,492,1983,4
2,66,40,26,5,73,59,14,5,492,1983,4
3,55,37,18,5,67,54,13,5,492,1983,4
4,46,34,12,5,74,60,14,5,492,1983,4
5,48,32,16,5,71,60,11,5,492,1983,4
6,59,39,20,5,62,51,11,5,492,1983,4
7,53,32,21,5,93,69,24,5,492,1983,4
8,55,32,23,5,84,63,21,5,492,1983,4
9,59,35,24,5,94,69,25,5,492,1983,4
10,60,36,24,5,79,61,18,5,492,1983,4
1,98,79,19,5,90,75,15,5,48,912,4
2,101,85,16,5,94,78,16,5,48,912,4
3,119,100,19,5,92,76,16,5,48,912,4
4,119,98,21,5,96,77,19,5,48,912,4
5,121,96,25,5,92,77,15,5,48,912,4
6,113,95,18,5,89,74,15,5,48,912,4
7,89,73,16,5,89,75,14,5,48,912,4
8,105,82,23,5,97,75,22,5,48,912,4
9,99,86,13,5,94,78,16,5,48,912,4
10,114,94,20,5,91,77,14,5,48,912,4
1,49,35,14,5,61,46,15,5,450,1446,4
2,65,41,24,5,75,62,13,5,450,1446,4
3,51,36,15,5,77,64,13,5,450,1446,4
4,48,35,13,5,76,61,15,5,450,1446,4
5,59,35,24,5,86,68,18,5,450,1446,4
6,61,40,21,5,68,50,18,5,450,1446,4
7,54,31,23,5,77,59,18,5,450,1446,4
8,58,35,23,5,69,53,16,5,450,1446,4
9,55,34,21,5,73,55,18,5,450,1446,4
10,62,38,24,5,76,57,19,5,450,1446,4
1,98,79,19,5,90,75,15,5,43,1683,4
2,101,85,16,5,94,78,16,5,43,1683,4
3,119,100,19,5,92,76,16,5,43,1683,4
4,119,98,21,5,96,77,19,5,43,1683,4
5,121,96,25,5,92,77,15,5,43,1683,4
6,113,95,18,5,89,74,15,5,43,1683,4
7,89,73,16,5,89,75,14,5,43,1683,4
8,105,82,23,5,97,75,22,5,43,1683,4
9,99,86,13,5,94,78,16,5,43,1683,4
10,114,94,20,5,91,77,14,5,43,1683,4
1,52,37,15,5,59,47,12,5,461,2938,4
2,66,40,26,5,73,59,14,5,461,2938,4
3,55,37,18,5,67,54,13,5,461,2938,4
4,46,34,12,5,74,60,14,5,461,2938,4
5,48,32,16,5,71,60,11,5,461,2938,4
6,59,39,20,5,62,51,11,5,461,2938,4
7,53,32,21,5,93,69,24,5,461,2938,4
8,55,32,23,5,84,63,21,5,461,2938,4
9,59,35,24,5,94,69,25,5,461,2938,4
10,60,36,24,5,79,61,18,5,461,2938,4
1,61,45,16,5,72,61,11,5,354,2189,4
2,68,47,21,5,75,61,14,5,354,2189,4
3,61,39,22,5,80,60,20,5,354,2189,4
4,57,41,16,5,81,62,19,5,354,2189,4
5,56,37,19,5,65,53,12,5,354,2189,4
6,80,49,31,5,71,59,12,5,354,2189,4
7,56,34,22,5,88,67,21,5,354,2189,4
8,52,37,15,5,62,47,15,5,354,2189,4
9,59,38,21,5,75,55,20,5,354,2189,4
10,48,34,14,5,75,57,18,5,354,2189,4
1,65,46,19,5,74,65,9,5,376,1094,4
2,68,49,19,5,72,55,17,5,376,1094,4
3,75,48,27,5,74,62,12,5,376,1094,4
4,79,51,28,5,75,57,18,5,376,1094,4
5,54,36,18,5,65,48,17,5,376,1094,4
6,63,41,22,5,75,56,19,5,376,1094,4
7,59,42,17,5,75,57,18,5,376,1094,4
8,55,39,16,5,85,66,19,5,376,1094,4
9,51,35,16,5,73,57,16,5,376,1094,4
10,59,41,18,5,87,69,18,5,376,1094,4
1,52,34,18,5,61,48,13,5,455,1710,4
2,68,40,28,5,74,59,15,5,455,1710,4
3,56,37,19,5,68,54,14,5,455,1710,4
4,50,38,12,5,77,62,15,5,455,1710,4
5,47,32,15,5,74,62,12,5,455,1710,4
6,62,40,22,5,64,53,11,5,455,1710,4
7,48,31,17,5,87,65,22,5,455,1710,4
8,55,33,22,5,85,67,18,5,455,1710,4
9,55,32,23,5,83,64,19,5,455,1710,4
10,57,33,24,5,92,68,24,5,455,1710,4
1,72,47,25,5,83,65,18,5,306,3204,4
2,71,51,20,5,76,59,17,5,306,3204,4
3,63,41,22,5,60,46,14,5,306,3204,4
4,67,43,24,5,64,49,15,5,306,3204,4
5,63,43,20,5,76,56,20,5,306,3204,4
6,68,42,26,5,71,57,14,5,306,3204,4
7,55,35,20,5,79,59,20,5,306,3204,4
8,52,37,15,5,82,67,15,5,306,3204,4
9,49,38,11,5,78,63,15,5,306,3204,4
10,60,42,18,5,69,54,15,5,306,3204,4
1,98,79,19,5,90,75,15,5,191,1988,4
2,101,85,16,5,94,78,16,5,191,1988,4
3,119,100,19,5,92,76,16,5,191,1988,4
4,119,98,21,5,96,77,19,5,191,1988,4
5,121,96,25,5,92,77,15,5,191,1988,4
6,113,95,18,5,89,74,15,5,191,1988,4
7,89,73,16,5,89,75,14,5,191,1988,4
8,105,82,23,5,97,75,22,5,191,1988,4
9,99,86,13,5,94,78,16,5,191,1988,4
10,114,94,20,5,91,77,14,5,191,1988,4
1,50,36,14,5,70,54,16,5,421,1241,4
2,60,38,22,5,98,73,25,5,421,1241,4
3,62,40,22,5,69,60,9,5,421,1241,4
4,55,35,20,5,76,57,19,5,421,1241,4
5,63,38,25,5,60,51,9,5,421,1241,4
6,59,37,22,5,79,59,20,5,421,1241,4
7,49,30,19,5,79,58,21,5,421,1241,4
8,49,31,18,5,71,56,15,5,421,1241,4
9,54,34,20,5,69,54,15,5,421,1241,4
10,48,33,15,5,80,62,18,5,421,1241,4
1,62,45,17,5,71,61,10,5,428,1198,4
2,56,39,17,5,77,61,16,5,428,1198,4
3,57,37,20,5,70,57,13,5,428,1198,4
4,58,39,19,5,78,61,17,5,428,1198,4
5,59,35,24,5,74,55,19,5,428,1198,4
6,53,35,18,5,77,55,22,5,428,1198,4
7,55,39,16,5,74,60,14,5,428,1198,4
8,50,32,18,5,60,44,16,5,428,1198,4
9,72,39,33,5,84,62,22,5,428,1198,4
10,60,38,22,5,70,56,14,5,428,1198,4
1,98,79,19,5,90,75,15,5,54,3530,4
2,101,85,16,5,94,78,16,5,54,3530,4
3,119,100,19,5,92,76,16,5,54,3530,4
4,119,98,21,5,96,77,19,5,54,3530,4
5,121,96,25,5,92,77,15,5,54,3530,4
6,113,95,18,5,89,74,15,5,54,3530,4
7,89,73,16,5,89,75,14,5,54,3530,4
8,105,82,23,5,97,75,22,5,54,3530,4
9,99,86,13,5,94,78,16,5,54,3530,4
10,114,94,20,5,91,77,14,5,54,3530,4
1,57,34,23,5,91,73,18,5,479,1366,4
2,66,36,30,5,101,78,23,5,479,1366,4
3,65,36,29,5,70,51,19,5,479,1366,4
4,53,35,18,5,104,73,31,5,479,1366,4
5,67,37,30,5,84,59,25,5,479,1366,4
6,70,45,25,5,88,64,24,5,479,1366,4
7,65,36,29,5,72,52,20,5,479,1366,4
8,58,39,19,5,100,76,24,5,479,1366,4
9,64,40,24,5,92,68,24,5,479,1366,4
10,83,47,36,5,87,70,17,5,479,1366,4
1,59,38,21,5,74,53,21,5,494,409,4
2,64,40,24,5,93,72,21,5,494,409,4
3,57,38,19,5,69,60,9,5,494,409,4
4,56,37,19,5,71,58,13,5,494,409,4
5,60,37,23,5,68,56,12,5,494,409,4
6,52,34,18,5,81,60,21,5,494,409,4
7,59,32,27,5,80,61,19,5,494,409,4
8,42,28,14,5,69,54,15,5,494,409,4
9,51,32,19,5,71,53,18,5,494,409,4
10,49,33,16,5,70,56,14,5,494,409,4
1,69,46,23,5,76,59,17,5,316,3211,4
2,69,47,22,5,73,57,16,5,316,3211,4
3,80,52,28,5,80,62,18,5,316,3211,4
4,69,48,21,5,84,67,17,5,316,3211,4
5,57,37,20,5,71,58,13,5,316,3211,4
6,59,37,22,5,66,52,14,5,316,3211,4
7,45,34,11,5,69,53,16,5,316,3211,4
8,55,36,19,5,70,56,14,5,316,3211,4
9,57,38,19,5,65,50,15,5,316,3211,4
10,50,33,17,5,87,64,23,5,316,3211,4
1,96,71,25,5,100,82,18,5,102,3416,4
2,94,70,24,5,104,80,24,5,102,3416,4
3,94,70,24,5,101,80,21,5,102,3416,4
4,95,69,26,5,102,81,21,5,102,3416,4
5,94,68,26,5,105,84,21,5,102,3416,4
6,98,68,30,5,104,82,22,5,102,3416,4
7,96,69,27,5,98,81,17,5,102,3416,4
8,95,66,29,5,102,83,19,5,102,3416,4
9,99,71,28,5,100,87,13,5,102,3416,4
10,100,69,31,5,98,84,14,5,102,3416,4
1,98,79,19,5,90,75,15,5,52,417,4
2,101,85,16,5,94,78,16,5,52,417,4
3,119,100,19,5,92,76,16,5,52,417,4
4,119,98,21,5,96,77,19,5,52,417,4
5,121,96,25,5,92,77,15,5,52,417,4
6,113,95,18,5,89,74,15,5,52,417,4
7,89,73,16,5,89,75,14,5,52,417,4
8,105,82,23,5,97,75,22,5,52,417,4
9,99,86,13,5,94,78,16,5,52,417,4
10,114,94,20,5,91,77,14,5,52,417,4
1,56,39,17,5,69,58,11,5,422,3186,4
2,51,38,13,5,70,58,12,5,422,3186,4
3,69,44,25,5,70,60,10,5,422,3186,4
4,59,36,23,5,83,66,17,5,422,3186,4
5,57,35,22,5,71,53,18,5,422,3186,4
6,58,38,20,5,72,54,18,5,422,3186,4
7,50,37,13,5,74,51,23,5,422,3186,4
8,56,39,17,5,83,64,19,5,422,3186,4
9,57,37,20,5,65,49,16,5,422,3186,4
10,68,41,27,5,72,53,19,5,422,3186,4
1,56,40,16,5,96,74,22,5,372,293,4
2,58,36,22,5,80,66,14,5,372,293,4
3,58,37,21,5,75,59,16,5,372,293,4
4,65,38,27,5,66,55,11,5,372,293,4
5,47,33,14,5,60,48,12,5,372,293,4
6,50,33,17,5,76,56,20,5,372,293,4
7,51,35,16,5,60,47,13,5,372,293,4
8,56,38,18,5,71,51,20,5,372,293,4
9,60,36,24,5,68,51,17,5,372,293,4
10,59,36,23,5,71,53,18,5,372,293,4
1,50,35,15,5,74,58,16,5,498,21,4
2,61,38,23,5,83,66,17,5,498,21,4
3,66,42,24,5,82,64,18,5,498,21,4
4,47,32,15,5,82,68,14,5,498,21,4
5,61,38,23,5,68,53,15,5,498,21,4
6,61,40,21,5,75,54,21,5,498,21,4
7,59,35,24,5,72,53,19,5,498,21,4
8,44,29,15,5,64,51,13,5,498,21,4
9,61,36,25,5,55,43,12,5,498,21,4
10,46,31,15,5,73,56,17,5,498,21,4
1,98,79,19,5,90,75,15,5,29,2534,4
2,101,85,16,5,94,78,16,5,29,2534,4
3,119,100,19,5,92,76,16,5,29,2534,4
4,119,98,21,5,96,77,19,5,29,2534,4
5,121,96,25,5,92,77,15,5,29,2534,4
6,113,95,18,5,89,74,15,5,29,2534,4
7,89,73,16,5,89,75,14,5,29,2534,4
8,105,82,23,5,97,75,22,5,29,2534,4
9,99,86,13,5,94,78,16,5,29,2534,4
10,114,94,20,5,91,77,14,5,29,2534,4
1,98,79,19,5,90,75,15,5,116,2229,4
2,101,85,16,5,94,78,16,5,116,2229,4
3,119,100,19,5,92,76,16,5,116,2229,4
4,119,98,21,5,96,77,19,5,116,2229,4
5,121,96,25,5,92,77,15,5,116,2229,4
6,113,95,18,5,89,74,15,5,116,2229,4
7,89,73,16,5,89,75,14,5,116,2229,4
8,105,82,23,5,97,75,22,5,116,2229,4
9,99,86,13,5,94,78,16,5,116,2229,4
10,114,94,20,5,91,77,14,5,116,2229,4
1,50,35,15,5,69,53,16,5,403,211,4
2,73,40,33,5,81,62,19,5,403,211,4
3,55,38,17,5,66,56,10,5,403,211,4
4,47,34,13,5,73,59,14,5,403,211,4
5,46,30,16,5,76,62,14,5,403,211,4
6,60,40,20,5,62,51,11,5,403,211,4
7,58,34,24,5,82,60,22,5,403,211,4
8,60,37,23,5,79,61,18,5,403,211,4
9,54,33,21,5,82,63,19,5,403,211,4
10,59,35,24,5,82,63,19,5,403,211,4
1,98,79,19,5,90,75,15,5,188,3595,4
2,101,85,16,5,94,78,16,5,188,3595,4
3,119,100,19,5,92,76,16,5,188,3595,4
4,119,98,21,5,96,77,19,5,188,3595,4
5,121,96,25,5,92,77,15,5,188,3595,4
6,113,95,18,5,89,74,15,5,188,3595,4
7,89,73,16,5,89,75,14,5,188,3595,4
8,105,82,23,5,97,75,22,5,188,3595,4
9,99,86,13,5,94,78,16,5,188,3595,4
10,114,94,20,5,91,77,14,5,188,3595,4
1,96,71,25,5,100,82,18,5,100,3088,4
2,94,70,24,5,104,80,24,5,100,3088,4
3,94,70,24,5,101,80,21,5,100,3088,4
4,95,69,26,5,102,81,21,5,100,3088,4
5,94,68,26,5,105,84,21,5,100,3088,4
6,98,68,30,5,104,82,22,5,100,3088,4
7,96,69,27,5,98,81,17,5,100,3088,4
8,95,66,29,5,102,83,19,5,100,3088,4
9,99,71,28,5,100,87,13,5,100,3088,4
10,100,69,31,5,98,84,14,5,100,3088,4
1,56,40,16,5,96,74,22,5,372,2671,4
2,58,36,22,5,80,66,14,5,372,2671,4
3,58,37,21,5,75,59,16,5,372,2671,4
4,65,38,27,5,66,55,11,5,372,2671,4
5,47,33,14,5,60,48,12,5,372,2671,4
6,50,33,17,5,76,56,20,5,372,2671,4
7,51,35,16,5,60,47,13,5,372,2671,4
8,56,38,18,5,71,51,20,5,372,2671,4
9,60,36,24,5,68,51,17,5,372,2671,4
10,59,36,23,5,71,53,18,5,372,2671,4
1,52,35,17,5,72,53,19,5,496,3213,4
2,62,39,23,5,73,58,15,5,496,3213,4
3,61,39,22,5,66,56,10,5,496,3213,4
4,47,35,12,5,71,57,14,5,496,3213,4
5,45,29,16,5,77,64,13,5,496,3213,4
6,55,38,17,5,61,50,11,5,496,3213,4
7,59,35,24,5,83,61,22,5,496,3213,4
8,60,38,22,5,79,62,17,5,496,3213,4
9,55,32,23,5,83,64,19,5,496,3213,4
10,60,36,24,5,86,64,22,5,496,3213,4
1,68,47,21,5,75,58,17,5,315,469,4
2,69,47,22,5,76,61,15,5,315,469,4
3,78,51,27,5,75,62,13,5,315,469,4
4,71,45,26,5,85,67,18,5,315,469,4
5,52,37,15,5,79,61,18,5,315,469,4
6,61,38,23,5,65,55,10,5,315,469,4
7,68,49,19,5,70,53,17,5,315,469,4
8,50,34,16,5,81,61,20,5,315,469,4
9,50,36,14,5,65,51,14,5,315,469,4
10,55,38,17,5,81,60,21,5,315,469,4
1,57,38,19,5,71,54,17,5,432,1443,4
2,66,40,26,5,75,60,15,5,432,1443,4
3,57,37,20,5,68,56,12,5,432,1443,4
4,42,34,8,5,73,59,14,5,432,1443,4
5,47,31,16,5,72,61,11,5,432,1443,4
6,54,38,16,5,66,53,13,5,432,1443,4
7,55,34,21,5,82,60,22,5,432,1443,4
8,57,33,24,5,79,60,19,5,432,1443,4
9,54,33,21,5,79,60,19,5,432,1443,4
10,64,36,28,5,86,65,21,5,432,1443,4
1,98,79,19,5,90,75,15,5,220,3140,4
2,101,85,16,5,94,78,16,5,220,3140,4
3,119,100,19,5,92,76,16,5,220,3140,4
4,119,98,21,5,96,77,19,5,220,3140,4
5,121,96,25,5,92,77,15,5,220,3140,4
6,113,95,18,5,89,74,15,5,220,3140,4
7,89,73,16,5,89,75,14,5,220,3140,4
8,105,82,23,5,97,75,22,5,220,3140,4
9,99,86,13,5,94,78,16,5,220,3140,4
10,114,94,20,5,91,77,14,5,220,3140,4
1,98,79,19,5,90,75,15,5,277,535,4
2,101,85,16,5,94,78,16,5,277,535,4
3,119,100,19,5,92,76,16,5,277,535,4
4,119,98,21,5,96,77,19,5,277,535,4
5,121,96,25,5,92,77,15,5,277,535,4
6,113,95,18,5,89,74,15,5,277,535,4
7,89,73,16,5,89,75,14,5,277,535,4
8,105,82,23,5,97,75,22,5,277,535,4
9,99,86,13,5,94,78,16,5,277,535,4
10,114,94,20,5,91,77,14,5,277,535,4
1,57,42,15,5,68,54,14,5,413,805,4
2,70,42,28,5,76,62,14,5,413,805,4
3,52,37,15,5,64,51,13,5,413,805,4
4,65,39,26,5,56,46,10,5,413,805,4
5,49,33,16,5,77,56,21,5,413,805,4
6,53,35,18,5,73,54,19,5,413,805,4
7,51,32,19,5,85,61,24,5,413,805,4
8,54,32,22,5,76,60,16,5,413,805,4
9,67,39,28,5,77,62,15,5,413,805,4
10,52,34,18,5,78,61,17,5,413,805,4
1,98,79,19,5,90,75,15,5,147,558,4
2,101,85,16,5,94,78,16,5,147,558,4
3,119,100,19,5,92,76,16,5,147,558,4
4,119,98,21,5,96,77,19,5,147,558,4
5,121,96,25,5,92,77,15,5,147,558,4
6,113,95,18,5,89,74,15,5,147,558,4
7,89,73,16,5,89,75,14,5,147,558,4
8,105,82,23,5,97,75,22,5,147,558,4
9,99,86,13,5,94,78,16,5,147,558,4
10,114,94,20,5,91,77,14,5,147,558,4
1,98,79,19,5,90,75,15,5,170,2216,4
2,101,85,16,5,94,78,16,5,170,2216,4
3,119,100,19,5,92,76,16,5,170,2216,4
4,119,98,21,5,96,77,19,5,170,2216,4
5,121,96,25,5,92,77,15,5,170,2216,4
6,113,95,18,5,89,74,15,5,170,2216,4
7,89,73,16,5,89,75,14,5,170,2216,4
8,105,82,23,5,97,75,22,5,170,2216,4
9,99,86,13,5,94,78,16,5,170,2216,4
10,114,94,20,5,91,77,14,5,170,2216,4
1,54,39,15,5,95,73,22,5,404,3805,4
2,52,42,10,5,77,61,16,5,404,3805,4
3,75,49,26,5,73,60,13,5,404,3805,4
4,64,41,23,5,72,57,15,5,404,3805,4
5,55,38,17,5,64,46,18,5,404,3805,4
6,58,37,21,5,53,44,9,5,404,3805,4
7,71,49,22,5,62,47,15,5,404,3805,4
8,58,40,18,5,80,64,16,5,404,3805,4
9,56,37,19,5,77,56,21,5,404,3805,4
10,77,51,26,5,77,57,20,5,404,3805,4
1,62,45,17,5,86,67,19,5,300,565,4
2,53,42,11,5,71,58,13,5,300,565,4
3,76,50,26,5,76,62,14,5,300,565,4
4,74,48,26,5,84,63,21,5,300,565,4
5,55,39,16,5,73,56,17,5,300,565,4
6,65,42,23,5,67,53,14,5,300,565,4
7,62,40,22,5,70,52,18,5,300,565,4
8,51,35,16,5,83,67,16,5,300,565,4
9,46,34,12,5,57,46,11,5,300,565,4
10,75,46,29,5,72,53,19,5,300,565,4
1,98,79,19,5,90,75,15,5,167,976,4
2,101,85,16,5,94,78,16,5,167,976,4
3,119,100,19,5,92,76,16,5,167,976,4
4,119,98,21,5,96,77,19,5,167,976,4
5,121,96,25,5,92,77,15,5,167,976,4
6,113,95,18,5,89,74,15,5,167,976,4
7,89,73,16,5,89,75,14,5,167,976,4
8,105,82,23,5,97,75,22,5,167,976,4
9,99,86,13,5,94,78,16,5,167,976,4
10,114,94,20,5,91,77,14,5,167,976,4
1,56,41,15,5,74,65,9,5,395,2039,4
2,67,47,20,5,80,62,18,5,395,2039,4
3,90,57,33,5,82,62,20,5,395,2039,4
4,63,48,15,5,78,58,20,5,395,2039,4
5,59,38,21,5,61,48,13,5,395,2039,4
6,64,41,23,5,56,43,13,5,395,2039,4
7,70,48,22,5,63,46,17,5,395,2039,4
8,49,39,10,5,78,60,18,5,395,2039,4
9,60,42,18,5,65,51,14,5,395,2039,4
10,63,40,23,5,87,66,21,5,395,2039,4
1,98,79,19,5,90,75,15,5,24,3584,4
2,101,85,16,5,94,78,16,5,24,3584,4
3,119,100,19,5,92,76,16,5,24,3584,4
4,119,98,21,5,96,77,19,5,24,3584,4
5,121,96,25,5,92,77,15,5,24,3584,4
6,113,95,18,5,89,74,15,5,24,3584,4
7,89,73,16,5,89,75,14,5,24,3584,4
8,105,82,23,5,97,75,22,5,24,3584,4
9,99,86,13,5,94,78,16,5,24,3584,4
10,114,94,20,5,91,77,14,5,24,3584,4
1,98,79,19,5,90,75,15,5,196,1316,4
2,101,85,16,5,94,78,16,5,196,1316,4
3,119,100,19,5,92,76,16,5,196,1316,4
4,119,98,21,5,96,77,19,5,196,1316,4
5,121,96,25,5,92,77,15,5,196,1316,4
6,113,95,18,5,89,74,15,5,196,1316,4
7,89,73,16,5,89,75,14,5,196,1316,4
8,105,82,23,5,97,75,22,5,196,1316,4
9,99,86,13,5,94,78,16,5,196,1316,4
10,114,94,20,5,91,77,14,5,196,1316,4
1,98,79,19,5,90,75,15,5,68,856,4
2,101,85,16,5,94,78,16,5,68,856,4
3,119,100,19,5,92,76,16,5,68,856,4
4,119,98,21,5,96,77,19,5,68,856,4
5,121,96,25,5,92,77,15,5,68,856,4
6,113,95,18,5,89,74,15,5,68,856,4
7,89,73,16,5,89,75,14,5,68,856,4
8,105,82,23,5,97,75,22,5,68,856,4
9,99,86,13,5,94,78,16,5,68,856,4
10,114,94,20,5,91,77,14,5,68,856,4
1,98,79,19,5,90,75,15,5,94,1397,4
2,101,85,16,5,94,78,16,5,94,1397,4
3,119,100,19,5,92,76,16,5,94,1397,4
4,119,98,21,5,96,77,19,5,94,1397,4
5,121,96,25,5,92,77,15,5,94,1397,4
6,113,95,18,5,89,74,15,5,94,1397,4
7,89,73,16,5,89,75,14,5,94,1397,4
8,105,82,23,5,97,75,22,5,94,1397,4
9,99,86,13,5,94,78,16,5,94,1397,4
10,114,94,20,5,91,77,14,5,94,1397,4
1,95,73,22,5,105,84,21,5,246,2092,4
2,94,73,21,5,103,85,18,5,246,2092,4
3,94,74,20,5,102,85,17,5,246,2092,4
4,104,75,29,5,99,86,13,5,246,2092,4
5,99,71,28,5,99,83,16,5,246,2092,4
6,98,67,31,5,100,80,20,5,246,2092,4
7,104,72,32,5,104,84,20,5,246,2092,4
8,96,67,29,5,103,85,18,5,246,2092,4
9,105,75,30,5,102,78,24,5,246,2092,4
10,93,73,20,5,100,77,23,5,246,2092,4
1,96,71,25,5,100,82,18,5,271,2495,4
2,94,70,24,5,104,80,24,5,271,2495,4
3,94,70,24,5,101,80,21,5,271,2495,4
4,95,69,26,5,102,81,21,5,271,2495,4
5,94,68,26,5,105,84,21,5,271,2495,4
6,98,68,30,5,104,82,22,5,271,2495,4
7,96,69,27,5,98,81,17,5,271,2495,4
8,95,66,29,5,102,83,19,5,271,2495,4
9,99,71,28,5,100,87,13,5,271,2495,4
10,100,69,31,5,98,84,14,5,271,2495,4
1,67,46,21,5,83,68,15,5,359,3326,4
2,57,40,17,5,73,61,12,5,359,3326,4
3,66,42,24,5,82,64,18,5,359,3326,4
4,56,37,19,5,60,48,12,5,359,3326,4
5,57,37,20,5,61,45,16,5,359,3326,4
6,65,40,25,5,72,56,16,5,359,3326,4
7,56,37,19,5,65,51,14,5,359,3326,4
8,54,34,20,5,76,58,18,5,359,3326,4
9,54,39,15,5,75,58,17,5,359,3326,4
10,59,39,20,5,96,72,24,5,359,3326,4
1,50,39,11,5,75,60,15,5,362,3784,4
2,70,49,21,5,82,64,18,5,362,3784,4
3,69,45,24,5,78,63,15,5,362,3784,4
4,80,55,25,5,89,70,19,5,362,3784,4
5,59,37,22,5,61,49,12,5,362,3784,4
6,63,40,23,5,75,59,16,5,362,3784,4
7,65,46,19,5,79,62,17,5,362,3784,4
8,58,41,17,5,65,55,10,5,362,3784,4
9,64,40,24,5,72,51,21,5,362,3784,4
10,64,44,20,5,74,54,20,5,362,3784,4
1,91,79,12,5,89,75,14,5,205,99,4
2,119,96,23,5,94,78,16,5,205,99,4
3,121,104,17,5,94,74,20,5,205,99,4
4,132,107,25,5,100,77,23,5,205,99,4
5,120,92,28,5,93,75,18,5,205,99,4
6,110,92,18,5,91,78,13,5,205,99,4
7,91,72,19,5,86,73,13,5,205,99,4
8,87,72,15,5,94,78,16,5,205,99,4
9,101,85,16,5,89,77,12,5,205,99,4
10,111,93,18,5,94,77,17,5,205,99,4
1,53,38,15,5,73,61,12,5,381,2618,4
2,57,38,19,5,82,66,16,5,381,2618,4
3,57,40,17,5,81,63,18,5,381,2618,4
4,53,35,18,5,54,43,11,5,381,2618,4
5,54,33,21,5,70,57,13,5,381,2618,4
6,54,36,18,5,65,51,14,5,381,2618,4
7,48,34,14,5,74,55,19,5,381,2618,4
8,56,34,22,5,90,68,22,5,381,2618,4
9,61,35,26,5,66,49,17,5,381,2618,4
10,72,42,30,5,79,57,22,5,381,2618,4
1,70,39,31,5,88,69,19,5,480,2172,4
2,57,36,21,5,96,71,25,5,480,2172,4
3,68,38,30,5,96,66,30,5,480,2172,4
4,64,39,25,5,85,65,20,5,480,2172,4
5,69,36,33,5,88,65,23,5,480,2172,4
6,66,43,23,5,82,61,21,5,480,2172,4
7,73,44,29,5,74,55,19,5,480,2172,4
8,66,45,21,5,88,64,24,5,480,2172,4
9,74,46,28,5,89,67,22,5,480,2172,4
10,61,39,22,5,91,69,22,5,480,2172,4
1,98,79,19,5,90,75,15,5,202,550,4
2,101,85,16,5,94,78,16,5,202,550,4
3,119,100,19,5,92,76,16,5,202,550,4
4,119,98,21,5,96,77,19,5,202,550,4
5,121,96,25,5,92,77,15,5,202,550,4
6,113,95,18,5,89,74,15,5,202,550,4
7,89,73,16,5,89,75,14,5,202,550,4
8,105,82,23,5,97,75,22,5,202,550,4
9,99,86,13,5,94,78,16,5,202,550,4
10,114,94,20,5,91,77,14,5,202,550,4
1,60,40,20,5,70,55,15,5,382,3252,4
2,57,37,20,5,74,60,14,5,382,3252,4
3,60,39,21,5,60,52,8,5,382,3252,4
4,55,39,16,5,94,71,23,5,382,3252,4
5,57,36,21,5,53,43,10,5,382,3252,4
6,55,37,18,5,86,66,20,5,382,3252,4
7,48,32,16,5,87,71,16,5,382,3252,4
8,55,32,23,5,72,56,16,5,382,3252,4
9,54,31,23,5,74,56,18,5,382,3252,4
10,58,36,22,5,66,44,22,5,382,3252,4
1,98,79,19,5,90,75,15,5,110,1129,4
2,101,85,16,5,94,78,16,5,110,1129,4
3,119,100,19,5,92,76,16,5,110,1129,4
4,119,98,21,5,96,77,19,5,110,1129,4
5,121,96,25,5,92,77,15,5,110,1129,4
6,113,95,18,5,89,74,15,5,110,1129,4
7,89,73,16,5,89,75,14,5,110,1129,4
8,105,82,23,5,97,75,22,5,110,1129,4
9,99,86,13,5,94,78,16,5,110,1129,4
10,114,94,20,5,91,77,14,5,110,1129,4
1,91,79,12,5,89,74,15,5,255,1102,4
2,120,96,24,5,93,77,16,5,255,1102,4
3,121,104,17,5,93,75,18,5,255,1102,4
4,130,107,23,5,101,78,23,5,255,1102,4
5,117,92,25,5,93,73,20,5,255,1102,4
6,110,92,18,5,89,75,14,5,255,1102,4
7,90,72,18,5,87,74,13,5,255,1102,4
8,89,72,17,5,93,77,16,5,255,1102,4
9,104,85,19,5,88,77,11,5,255,1102,4
10,110,93,17,5,92,76,16,5,255,1102,4
1,63,46,17,5,86,73,13,5,303,194,4
2,55,43,12,5,76,57,19,5,303,194,4
3,80,53,27,5,68,56,12,5,303,194,4
4,69,46,23,5,74,55,19,5,303,194,4
5,52,38,14,5,69,51,18,5,303,194,4
6,55,39,16,5,70,54,16,5,303,194,4
7,58,38,20,5,61,47,14,5,303,194,4
8,59,37,22,5,93,73,20,5,303,194,4
9,55,35,20,5,66,55,11,5,303,194,4
10,73,47,26,5,79,59,20,5,303,194,4
1,101,82,19,5,92,75,17,5,260,631,4
2,109,89,20,5,93,74,19,5,260,631,4
3,115,97,18,5,94,74,20,5,260,631,4
4,124,106,18,5,93,79,14,5,260,631,4
5,119,91,28,5,92,76,16,5,260,631,4
6,110,94,16,5,91,78,13,5,260,631,4
7,88,72,16,5,91,75,16,5,260,631,4
8,84,68,16,5,95,79,16,5,260,631,4
9,107,90,17,5,89,76,13,5,260,631,4
10,115,93,22,5,94,76,18,5,260,631,4
1,98,79,19,5,90,75,15,5,278,873,4
2,101,85,16,5,94,78,16,5,278,873,4
3,119,100,19,5,92,76,16,5,278,873,4
4,119,98,21,5,96,77,19,5,278,873,4
5,121,96,25,5,92,77,15,5,278,873,4
6,113,95,18,5,89,74,15,5,278,873,4
7,89,73,16,5,89,75,14,5,278,873,4
8,105,82,23,5,97,75,22,5,278,873,4
9,99,86,13,5,94,78,16,5,278,873,4
10,114,94,20,5,91,77,14,5,278,873,4
1,98,79,19,5,90,75,15,5,69,3542,4
2,101,85,16,5,94,78,16,5,69,3542,4
3,119,100,19,5,92,76,16,5,69,3542,4
4,119,98,21,5,96,77,19,5,69,3542,4
5,121,96,25,5,92,77,15,5,69,3542,4
6,113,95,18,5,89,74,15,5,69,3542,4
7,89,73,16,5,89,75,14,5,69,3542,4
8,105,82,23,5,97,75,22,5,69,3542,4
9,99,86,13,5,94,78,16,5,69,3542,4
10,114,94,20,5,91,77,14,5,69,3542,4
1,98,79,19,5,90,75,15,5,195,1976,4
2,101,85,16,5,94,78,16,5,195,1976,4
3,119,100,19,5,92,76,16,5,195,1976,4
4,119,98,21,5,96,77,19,5,195,1976,4
5,121,96,25,5,92,77,15,5,195,1976,4
6,113,95,18,5,89,74,15,5,195,1976,4
7,89,73,16,5,89,75,14,5,195,1976,4
8,105,82,23,5,97,75,22,5,195,1976,4
9,99,86,13,5,94,78,16,5,195,1976,4
10,114,94,20,5,91,77,14,5,195,1976,4
1,95,73,22,5,105,84,21,5,9,116,4
2,94,73,21,5,103,85,18,5,9,116,4
3,94,74,20,5,102,85,17,5,9,116,4
4,104,75,29,5,99,86,13,5,9,116,4
5,99,71,28,5,99,83,16,5,9,116,4
6,98,67,31,5,100,80,20,5,9,116,4
7,104,72,32,5,104,84,20,5,9,116,4
8,96,67,29,5,103,85,18,5,9,116,4
9,105,75,30,5,102,78,24,5,9,116,4
10,93,73,20,5,100,77,23,5,9,116,4
1,98,79,19,5,90,75,15,5,287,475,4
2,101,85,16,5,94,78,16,5,287,475,4
3,119,100,19,5,92,76,16,5,287,475,4
4,119,98,21,5,96,77,19,5,287,475,4
5,121,96,25,5,92,77,15,5,287,475,4
6,113,95,18,5,89,74,15,5,287,475,4
7,89,73,16,5,89,75,14,5,287,475,4
8,105,82,23,5,97,75,22,5,287,475,4
9,99,86,13,5,94,78,16,5,287,475,4
10,114,94,20,5,91,77,14,5,287,475,4
1,98,79,19,5,90,75,15,5,232,2319,4
2,101,85,16,5,94,78,16,5,232,2319,4
3,119,100,19,5,92,76,16,5,232,2319,4
4,119,98,21,5,96,77,19,5,232,2319,4
5,121,96,25,5,92,77,15,5,232,2319,4
6,113,95,18,5,89,74,15,5,232,2319,4
7,89,73,16,5,89,75,14,5,232,2319,4
8,105,82,23,5,97,75,22,5,232,2319,4
9,99,86,13,5,94,78,16,5,232,2319,4
10,114,94,20,5,91,77,14,5,232,2319,4
1,98,79,19,5,90,75,15,5,168,158,4
2,101,85,16,5,94,78,16,5,168,158,4
3,119,100,19,5,92,76,16,5,168,158,4
4,119,98,21,5,96,77,19,5,168,158,4
5,121,96,25,5,92,77,15,5,168,158,4
6,113,95,18,5,89,74,15,5,168,158,4
7,89,73,16,5,89,75,14,5,168,158,4
8,105,82,23,5,97,75,22,5,168,158,4
9,99,86,13,5,94,78,16,5,168,158,4
10,114,94,20,5,91,77,14,5,168,158,4
1,98,79,19,5,90,75,15,5,59,565,4
2,101,85,16,5,94,78,16,5,59,565,4
3,119,100,19,5,92,76,16,5,59,565,4
4,119,98,21,5,96,77,19,5,59,565,4
5,121,96,25,5,92,77,15,5,59,565,4
6,113,95,18,5,89,74,15,5,59,565,4
7,89,73,16,5,89,75,14,5,59,565,4
8,105,82,23,5,97,75,22,5,59,565,4
9,99,86,13,5,94,78,16,5,59,565,4
10,114,94,20,5,91,77,14,5,59,565,4
1,52,37,15,5,59,47,12,5,449,3737,4
2,66,40,26,5,73,59,14,5,449,3737,4
3,55,37,18,5,67,54,13,5,449,3737,4
4,46,34,12,5,74,60,14,5,449,3737,4
5,48,32,16,5,71,60,11,5,449,3737,4
6,59,39,20,5,62,51,11,5,449,3737,4
7,53,32,21,5,93,69,24,5,449,3737,4
8,55,32,23,5,84,63,21,5,449,3737,4
9,59,35,24,5,94,69,25,5,449,3737,4
10,60,36,24,5,79,61,18,5,449,3737,4
1,56,41,15,5,75,59,16,5,295,165,4
2,82,53,29,5,76,58,18,5,295,165,4
3,76,51,25,5,84,65,19,5,295,165,4
4,71,48,23,5,83,67,16,5,295,165,4
5,60,36,24,5,83,65,18,5,295,165,4
6,60,42,18,5,72,59,13,5,295,165,4
7,56,39,17,5,60,46,14,5,295,165,4
8,51,33,18,5,69,54,15,5,295,165,4
9,48,33,15,5,66,52,14,5,295,165,4
10,54,36,18,5,76,56,20,5,295,165,4
1,98,79,19,5,90,75,15,5,171,2419,4
2,101,85,16,5,94,78,16,5,171,2419,4
3,119,100,19,5,92,76,16,5,171,2419,4
4,119,98,21,5,96,77,19,5,171,2419,4
5,121,96,25,5,92,77,15,5,171,2419,4
6,113,95,18,5,89,74,15,5,171,2419,4
7,89,73,16,5,89,75,14,5,171,2419,4
8,105,82,23,5,97,75,22,5,171,2419,4
9,99,86,13,5,94,78,16,5,171,2419,4
10,114,94,20,5,91,77,14,5,171,2419,4
1,54,43,11,5,94,74,20,5,367,865,4
2,67,49,18,5,74,61,13,5,367,865,4
3,80,50,30,5,88,67,21,5,367,865,4
4,73,46,27,5,85,68,17,5,367,865,4
5,48,35,13,5,58,44,14,5,367,865,4
6,56,37,19,5,61,46,15,5,367,865,4
7,52,35,17,5,65,52,13,5,367,865,4
8,54,40,14,5,69,54,15,5,367,865,4
9,62,38,24,5,71,48,23,5,367,865,4
10,64,42,22,5,64,53,11,5,367,865,4
1,98,79,19,5,90,75,15,5,13,3094,4
2,101,85,16,5,94,78,16,5,13,3094,4
3,119,100,19,5,92,76,16,5,13,3094,4
4,119,98,21,5,96,77,19,5,13,3094,4
5,121,96,25,5,92,77,15,5,13,3094,4
6,113,95,18,5,89,74,15,5,13,3094,4
7,89,73,16,5,89,75,14,5,13,3094,4
8,105,82,23,5,97,75,22,5,13,3094,4
9,99,86,13,5,94,78,16,5,13,3094,4
10,114,94,20,5,91,77,14,5,13,3094,4
1,98,79,19,5,90,75,15,5,276,287,4
2,101,85,16,5,94,78,16,5,276,287,4
3,119,100,19,5,92,76,16,5,276,287,4
4,119,98,21,5,96,77,19,5,276,287,4
5,121,96,25,5,92,77,15,5,276,287,4
6,113,95,18,5,89,74,15,5,276,287,4
7,89,73,16,5,89,75,14,5,276,287,4
8,105,82,23,5,97,75,22,5,276,287,4
9,99,86,13,5,94,78,16,5,276,287,4
10,114,94,20,5,91,77,14,5,276,287,4
1,73,50,23,5,78,62,16,5,347,3368,4
2,62,46,16,5,81,59,22,5,347,3368,4
3,69,44,25,5,80,65,15,5,347,3368,4
4,57,38,19,5,90,71,19,5,347,3368,4
5,59,38,21,5,74,58,16,5,347,3368,4
6,61,38,23,5,79,66,13,5,347,3368,4
7,51,36,15,5,53,40,13,5,347,3368,4
8,62,42,20,5,65,53,12,5,347,3368,4
9,62,41,21,5,60,46,14,5,347,3368,4
10,55,40,15,5,76,52,24,5,347,3368,4
1,75,50,25,5,95,69,26,5,340,2566,4
2,74,45,29,5,99,68,31,5,340,2566,4
3,67,40,27,5,95,74,21,5,340,2566,4
4,60,35,25,5,90,70,20,5,340,2566,4
5,56,34,22,5,72,56,16,5,340,2566,4
6,58,36,22,5,93,70,23,5,340,2566,4
7,64,39,25,5,71,51,20,5,340,2566,4
8,76,46,30,5,69,53,16,5,340,2566,4
9,78,47,31,5,93,67,26,5,340,2566,4
10,86,53,33,5,89,63,26,5,340,2566,4
1,57,38,19,5,71,54,17,5,430,854,4
2,66,40,26,5,75,60,15,5,430,854,4
3,57,37,20,5,68,56,12,5,430,854,4
4,42,34,8,5,73,59,14,5,430,854,4
5,47,31,16,5,72,61,11,5,430,854,4
6,54,38,16,5,66,53,13,5,430,854,4
7,55,34,21,5,82,60,22,5,430,854,4
8,57,33,24,5,79,60,19,5,430,854,4
9,54,33,21,5,79,60,19,5,430,854,4
10,64,36,28,5,86,65,21,5,430,854,4
1,60,42,18,5,70,56,14,5,495,348,4
2,65,40,25,5,74,62,12,5,495,348,4
3,59,38,21,5,71,58,13,5,495,348,4
4,58,39,19,5,80,63,17,5,495,348,4
5,52,30,22,5,58,46,12,5,495,348,4
6,59,38,21,5,81,58,23,5,495,348,4
7,48,33,15,5,74,57,17,5,495,348,4
8,49,32,17,5,86,62,24,5,495,348,4
9,46,29,17,5,72,58,14,5,495,348,4
10,57,33,24,5,64,48,16,5,495,348,4
1,63,33,30,5,94,74,20,5,475,2687,4
2,62,39,23,5,103,76,27,5,475,2687,4
3,64,37,27,5,70,52,18,5,475,2687,4
4,70,43,27,5,91,64,27,5,475,2687,4
5,51,31,20,5,83,62,21,5,475,2687,4
6,62,40,22,5,75,51,24,5,475,2687,4
7,70,42,28,5,68,46,22,5,475,2687,4
8,70,47,23,5,99,73,26,5,475,2687,4
9,76,44,32,5,101,77,24,5,475,2687,4
10,67,37,30,5,91,75,16,5,475,2687,4
1,95,73,22,5,105,84,21,5,243,2592,4
2,94,73,21,5,103,85,18,5,243,2592,4
3,94,74,20,5,102,85,17,5,243,2592,4
4,104,75,29,5,99,86,13,5,243,2592,4
5,99,71,28,5,99,83,16,5,243,2592,4
6,98,67,31,5,100,80,20,5,243,2592,4
7,104,72,32,5,104,84,20,5,243,2592,4
8,96,67,29,5,103,85,18,5,243,2592,4
9,105,75,30,5,102,78,24,5,243,2592,4
10,93,73,20,5,100,77,23,5,243,2592,4
1,61,42,19,5,87,66,21,5,441,1209,4
2,54,34,20,5,77,63,14,5,441,1209,4
3,59,39,20,5,72,59,13,5,441,1209,4
4,52,36,16,5,72,60,12,5,441,1209,4
5,54,36,18,5,75,58,17,5,441,1209,4
6,65,42,23,5,78,62,16,5,441,1209,4
7,54,33,21,5,72,54,18,5,441,1209,4
8,48,30,18,5,57,43,14,5,441,1209,4
9,59,33,26,5,72,55,17,5,441,1209,4
10,54,34,20,5,76,56,20,5,441,1209,4
1,98,79,19,5,90,75,15,5,212,77,4
2,101,85,16,5,94,78,16,5,212,77,4
3,119,100,19,5,92,76,16,5,212,77,4
4,119,98,21,5,96,77,19,5,212,77,4
5,121,96,25,5,92,77,15,5,212,77,4
6,113,95,18,5,89,74,15,5,212,77,4
7,89,73,16,5,89,75,14,5,212,77,4
8,105,82,23,5,97,75,22,5,212,77,4
9,99,86,13,5,94,78,16,5,212,77,4
10,114,94,20,5,91,77,14,5,212,77,4
1,58,42,16,5,63,49,14,5,324,2167,4
2,60,47,13,5,52,43,9,5,324,2167,4
3,65,45,20,5,77,62,15,5,324,2167,4
4,76,48,28,5,99,76,23,5,324,2167,4
5,47,33,14,5,71,55,16,5,324,2167,4
6,60,38,22,5,74,59,15,5,324,2167,4
7,58,37,21,5,89,68,21,5,324,2167,4
8,59,37,22,5,83,64,19,5,324,2167,4
9,57,36,21,5,68,55,13,5,324,2167,4
10,50,33,17,5,68,49,19,5,324,2167,4
1,69,47,22,5,79,61,18,5,433,2524,4
2,63,39,24,5,77,63,14,5,433,2524,4
3,59,39,20,5,79,66,13,5,433,2524,4
4,54,36,18,5,74,55,19,5,433,2524,4
5,63,38,25,5,64,48,16,5,433,2524,4
6,54,38,16,5,77,60,17,5,433,2524,4
7,60,36,24,5,69,55,14,5,433,2524,4
8,41,30,11,5,61,48,13,5,433,2524,4
9,61,36,25,5,65,50,15,5,433,2524,4
10,61,39,22,5,83,60,23,5,433,2524,4
1,61,43,18,5,67,54,13,5,348,3088,4
2,75,49,26,5,73,55,18,5,348,3088,4
3,65,44,21,5,65,52,13,5,348,3088,4
4,65,44,21,5,82,62,20,5,348,3088,4
5,42,30,12,5,75,57,18,5,348,3088,4
6,64,42,22,5,75,63,12,5,348,3088,4
7,62,38,24,5,75,58,17,5,348,3088,4
8,54,35,19,5,80,67,13,5,348,3088,4
9,63,39,24,5,78,56,22,5,348,3088,4
10,52,36,16,5,69,52,17,5,348,3088,4
1,54,37,17,5,76,54,22,5,414,1398,4
2,67,42,25,5,81,66,15,5,414,1398,4
3,62,41,21,5,71,59,12,5,414,1398,4
4,51,34,17,5,81,64,17,5,414,1398,4
5,53,33,20,5,71,56,15,5,414,1398,4
6,55,37,18,5,86,66,20,5,414,1398,4
7,51,32,19,5,73,59,14,5,414,1398,4
8,55,33,22,5,70,54,16,5,414,1398,4
9,53,30,23,5,62,48,14,5,414,1398,4
10,51,31,20,5,70,52,18,5,414,1398,4
1,95,73,22,5,105,84,21,5,243,2866,4
2,94,73,21,5,103,85,18,5,243,2866,4
3,94,74,20,5,102,85,17,5,243,2866,4
4,104,75,29,5,99,86,13,5,243,2866,4
5,99,71,28,5,99,83,16,5,243,2866,4
6,98,67,31,5,100,80,20,5,243,2866,4
7,104,72,32,5,104,84,20,5,243,2866,4
8,96,67,29,5,103,85,18,5,243,2866,4
9,105,75,30,5,102,78,24,5,243,2866,4
10,93,73,20,5,100,77,23,5,243,2866,4
1,95,73,22,5,105,84,21,5,244,1288,4
2,94,73,21,5,103,85,18,5,244,1288,4
3,94,74,20,5,102,85,17,5,244,1288,4
4,104,75,29,5,99,86,13,5,244,1288,4
5,99,71,28,5,99,83,16,5,244,1288,4
6,98,67,31,5,100,80,20,5,244,1288,4
7,104,72,32,5,104,84,20,5,244,1288,4
8,96,67,29,5,103,85,18,5,244,1288,4
9,105,75,30,5,102,78,24,5,244,1288,4
10,93,73,20,5,100,77,23,5,244,1288,4
1,98,79,19,5,90,75,15,5,225,457,4
2,101,85,16,5,94,78,16,5,225,457,4
3,119,100,19,5,92,76,16,5,225,457,4
4,119,98,21,5,96,77,19,5,225,457,4
5,121,96,25,5,92,77,15,5,225,457,4
6,113,95,18,5,89,74,15,5,225,457,4
7,89,73,16,5,89,75,14,5,225,457,4
8,105,82,23,5,97,75,22,5,225,457,4
9,99,86,13,5,94,78,16,5,225,457,4
10,114,94,20,5,91,77,14,5,225,457,4
1,57,38,19,5,71,54,17,5,452,3542,4
2,66,40,26,5,75,60,15,5,452,3542,4
3,57,37,20,5,68,56,12,5,452,3542,4
4,42,34,8,5,73,59,14,5,452,3542,4
5,47,31,16,5,72,61,11,5,452,3542,4
6,54,38,16,5,66,53,13,5,452,3542,4
7,55,34,21,5,82,60,22,5,452,3542,4
8,57,33,24,5,79,60,19,5,452,3542,4
9,54,33,21,5,79,60,19,5,452,3542,4
10,64,36,28,5,86,65,21,5,452,3542,4
1,78,52,26,5,100,71,29,5,346,2949,4
2,54,39,15,5,96,76,20,5,346,2949,4
3,66,43,23,5,94,71,23,5,346,2949,4
4,84,55,29,5,82,59,23,5,346,2949,4
5,98,61,37,5,97,72,25,5,346,2949,4
6,54,35,19,5,80,59,21,5,346,2949,4
7,58,35,23,5,97,75,22,5,346,2949,4
8,66,38,28,5,69,50,19,5,346,2949,4
9,71,42,29,5,96,68,28,5,346,2949,4
10,72,43,29,5,84,69,15,5,346,2949,4
1,79,68,11,5,92,79,13,5,274,3093,4
2,113,89,24,5,94,76,18,5,274,3093,4
3,106,82,24,5,95,75,20,5,274,3093,4
4,125,102,23,5,91,76,15,5,274,3093,4
5,101,78,23,5,94,77,17,5,274,3093,4
6,102,83,19,5,89,73,16,5,274,3093,4
7,103,88,15,5,91,76,15,5,274,3093,4
8,110,92,18,5,93,76,17,5,274,3093,4
9,119,99,20,5,91,75,16,5,274,3093,4
10,107,94,13,5,94,79,15,5,274,3093,4
1,98,79,19,5,90,75,15,5,82,3223,4
2,101,85,16,5,94,78,16,5,82,3223,4
3,119,100,19,5,92,76,16,5,82,3223,4
4,119,98,21,5,96,77,19,5,82,3223,4
5,121,96,25,5,92,77,15,5,82,3223,4
6,113,95,18,5,89,74,15,5,82,3223,4
7,89,73,16,5,89,75,14,5,82,3223,4
8,105,82,23,5,97,75,22,5,82,3223,4
9,99,86,13,5,94,78,16,5,82,3223,4
10,114,94,20,5,91,77,14,5,82,3223,4
1,65,45,20,5,87,66,21,5,337,2414,4
2,86,54,32,5,102,77,25,5,337,2414,4
3,68,44,24,5,97,72,25,5,337,2414,4
4,70,41,29,5,100,74,26,5,337,2414,4
5,61,35,26,5,98,77,21,5,337,2414,4
6,59,36,23,5,80,63,17,5,337,2414,4
7,62,38,24,5,61,44,17,5,337,2414,4
8,71,41,30,5,62,45,17,5,337,2414,4
9,82,52,30,5,74,50,24,5,337,2414,4
10,83,54,29,5,102,70,32,5,337,2414,4
1,62,42,20,5,81,66,15,5,374,2040,4
2,63,37,26,5,76,60,16,5,374,2040,4
3,57,39,18,5,76,57,19,5,374,2040,4
4,53,36,17,5,76,59,17,5,374,2040,4
5,56,33,23,5,58,47,11,5,374,2040,4
6,57,36,21,5,72,55,17,5,374,2040,4
7,52,35,17,5,89,67,22,5,374,2040,4
8,56,40,16,5,58,47,11,5,374,2040,4
9,58,36,22,5,81,63,18,5,374,2040,4
10,64,40,24,5,71,55,16,5,374,2040,4
1,64,46,18,5,78,64,14,5,383,1444,4
2,62,44,18,5,86,62,24,5,383,1444,4
3,60,41,19,5,74,64,10,5,383,1444,4
4,63,42,21,5,85,67,18,5,383,1444,4
5,57,35,22,5,78,61,17,5,383,1444,4
6,59,39,20,5,62,47,15,5,383,1444,4
7,62,41,21,5,68,56,12,5,383,1444,4
8,58,40,18,5,79,62,17,5,383,1444,4
9,61,44,17,5,72,56,16,5,383,1444,4
10,66,41,25,5,73,52,21,5,383,1444,4
1,98,79,19,5,90,75,15,5,104,2618,4
2,101,85,16,5,94,78,16,5,104,2618,4
3,119,100,19,5,92,76,16,5,104,2618,4
4,119,98,21,5,96,77,19,5,104,2618,4
5,121,96,25,5,92,77,15,5,104,2618,4
6,113,95,18,5,89,74,15,5,104,2618,4
7,89,73,16,5,89,75,14,5,104,2618,4
8,105,82,23,5,97,75,22,5,104,2618,4
9,99,86,13,5,94,78,16,5,104,2618,4
10,114,94,20,5,91,77,14,5,104,2618,4
1,98,79,19,5,90,75,15,5,259,60,4
2,101,85,16,5,94,78,16,5,259,60,4
3,119,100,19,5,92,76,16,5,259,60,4
4,119,98,21,5,96,77,19,5,259,60,4
5,121,96,25,5,92,77,15,5,259,60,4
6,113,95,18,5,89,74,15,5,259,60,4
7,89,73,16,5,89,75,14,5,259,60,4
8,105,82,23,5,97,75,22,5,259,60,4
9,99,86,13,5,94,78,16,5,259,60,4
10,114,94,20,5,91,77,14,5,259,60,4
1,96,71,25,5,100,82,18,5,267,1094,4
2,94,70,24,5,104,80,24,5,267,1094,4
3,94,70,24,5,101,80,21,5,267,1094,4
4,95,69,26,5,102,81,21,5,267,1094,4
5,94,68,26,5,105,84,21,5,267,1094,4
6,98,68,30,5,104,82,22,5,267,1094,4
7,96,69,27,5,98,81,17,5,267,1094,4
8,95,66,29,5,102,83,19,5,267,1094,4
9,99,71,28,5,100,87,13,5,267,1094,4
10,100,69,31,5,98,84,14,5,267,1094,4
1,59,45,14,5,80,64,16,5,343,3568,4
2,66,47,19,5,67,53,14,5,343,3568,4
3,69,45,24,5,71,55,16,5,343,3568,4
4,69,45,24,5,94,72,22,5,343,3568,4
5,51,34,17,5,79,61,18,5,343,3568,4
6,52,35,17,5,80,63,17,5,343,3568,4
7,63,38,25,5,71,54,17,5,343,3568,4
8,77,46,31,5,79,61,18,5,343,3568,4
9,47,35,12,5,53,43,10,5,343,3568,4
10,56,38,18,5,66,51,15,5,343,3568,4
1,67,45,22,5,82,61,21,5,305,1530,4
2,65,46,19,5,71,59,12,5,305,1530,4
3,65,44,21,5,78,61,17,5,305,1530,4
4,73,49,24,5,83,66,17,5,305,1530,4
5,60,36,24,5,76,58,18,5,305,1530,4
6,58,39,19,5,60,50,10,5,305,1530,4
7,57,37,20,5,80,61,19,5,305,1530,4
8,70,46,24,5,69,56,13,5,305,1530,4
9,49,33,16,5,70,53,17,5,305,1530,4
10,52,35,17,5,67,49,18,5,305,1530,4
1,92,78,14,5,88,75,13,5,144,2025,4
2,119,96,23,5,93,75,18,5,144,2025,4
3,114,99,15,5,94,74,20,5,144,2025,4
4,118,100,18,5,94,77,17,5,144,2025,4
5,122,97,25,5,94,77,17,5,144,2025,4
6,122,99,23,5,90,72,18,5,144,2025,4
7,104,82,22,5,92,75,17,5,144,2025,4
8,85,69,16,5,93,77,16,5,144,2025,4
9,104,84,20,5,87,77,10,5,144,2025,4
10,109,94,15,5,93,77,16,5,144,2025,4
1,91,79,12,5,89,74,15,5,192,1562,4
2,120,96,24,5,93,77,16,5,192,1562,4
3,121,104,17,5,93,75,18,5,192,1562,4
4,130,107,23,5,101,78,23,5,192,1562,4
5,117,92,25,5,93,73,20,5,192,1562,4
6,110,92,18,5,89,75,14,5,192,1562,4
7,90,72,18,5,87,74,13,5,192,1562,4
8,89,72,17,5,93,77,16,5,192,1562,4
9,104,85,19,5,88,77,11,5,192,1562,4
10,110,93,17,5,92,76,16,5,192,1562,4
1,68,47,21,5,75,58,17,5,315,1483,4
2,69,47,22,5,76,61,15,5,315,1483,4
3,78,51,27,5,75,62,13,5,315,1483,4
4,71,45,26,5,85,67,18,5,315,1483,4
5,52,37,15,5,79,61,18,5,315,1483,4
6,61,38,23,5,65,55,10,5,315,1483,4
7,68,49,19,5,70,53,17,5,315,1483,4
8,50,34,16,5,81,61,20,5,315,1483,4
9,50,36,14,5,65,51,14,5,315,1483,4
10,55,38,17,5,81,60,21,5,315,1483,4
1,52,37,15,5,59,47,12,5,449,1500,4
2,66,40,26,5,73,59,14,5,449,1500,4
3,55,37,18,5,67,54,13,5,449,1500,4
4,46,34,12,5,74,60,14,5,449,1500,4
5,48,32,16,5,71,60,11,5,449,1500,4
6,59,39,20,5,62,51,11,5,449,1500,4
7,53,32,21,5,93,69,24,5,449,1500,4
8,55,32,23,5,84,63,21,5,449,1500,4
9,59,35,24,5,94,69,25,5,449,1500,4
10,60,36,24,5,79,61,18,5,449,1500,4
1,64,46,18,5,72,60,12,5,363,3330,4
2,78,56,22,5,67,54,13,5,363,3330,4
3,64,42,22,5,71,53,18,5,363,3330,4
4,68,44,24,5,85,65,20,5,363,3330,4
5,49,36,13,5,65,45,20,5,363,3330,4
6,61,38,23,5,57,45,12,5,363,3330,4
7,53,35,18,5,79,63,16,5,363,3330,4
8,56,41,15,5,95,75,20,5,363,3330,4
9,61,41,20,5,74,61,13,5,363,3330,4
10,63,39,24,5,88,67,21,5,363,3330,4
1,98,79,19,5,90,75,15,5,171,792,4
2,101,85,16,5,94,78,16,5,171,792,4
3,119,100,19,5,92,76,16,5,171,792,4
4,119,98,21,5,96,77,19,5,171,792,4
5,121,96,25,5,92,77,15,5,171,792,4
6,113,95,18,5,89,74,15,5,171,792,4
7,89,73,16,5,89,75,14,5,171,792,4
8,105,82,23,5,97,75,22,5,171,792,4
9,99,86,13,5,94,78,16,5,171,792,4
10,114,94,20,5,91,77,14,5,171,792,4
1,98,79,19,5,90,75,15,5,204,2806,4
2,101,85,16,5,94,78,16,5,204,2806,4
3,119,100,19,5,92,76,16,5,204,2806,4
4,119,98,21,5,96,77,19,5,204,2806,4
5,121,96,25,5,92,77,15,5,204,2806,4
6,113,95,18,5,89,74,15,5,204,2806,4
7,89,73,16,5,89,75,14,5,204,2806,4
8,105,82,23,5,97,75,22,5,204,2806,4
9,99,86,13,5,94,78,16,5,204,2806,4
10,114,94,20,5,91,77,14,5,204,2806,4
1,98,79,19,5,90,75,15,5,251,3280,4
2,101,85,16,5,94,78,16,5,251,3280,4
3,119,100,19,5,92,76,16,5,251,3280,4
4,119,98,21,5,96,77,19,5,251,3280,4
5,121,96,25,5,92,77,15,5,251,3280,4
6,113,95,18,5,89,74,15,5,251,3280,4
7,89,73,16,5,89,75,14,5,251,3280,4
8,105,82,23,5,97,75,22,5,251,3280,4
9,99,86,13,5,94,78,16,5,251,3280,4
10,114,94,20,5,91,77,14,5,251,3280,4
1,61,43,18,5,82,71,11,5,356,1949,4
2,57,40,17,5,92,75,17,5,356,1949,4
3,66,48,18,5,79,65,14,5,356,1949,4
4,50,39,11,5,67,51,16,5,356,1949,4
5,71,46,25,5,64,48,16,5,356,1949,4
6,81,52,29,5,75,55,20,5,356,1949,4
7,67,45,22,5,64,50,14,5,356,1949,4
8,68,43,25,5,75,58,17,5,356,1949,4
9,59,40,19,5,73,54,19,5,356,1949,4
10,65,42,23,5,84,64,20,5,356,1949,4
1,79,68,11,5,92,79,13,5,272,3840,4
2,113,89,24,5,94,76,18,5,272,3840,4
3,106,82,24,5,95,75,20,5,272,3840,4
4,125,102,23,5,91,76,15,5,272,3840,4
5,101,78,23,5,94,77,17,5,272,3840,4
6,102,83,19,5,89,73,16,5,272,3840,4
7,103,88,15,5,91,76,15,5,272,3840,4
8,110,92,18,5,93,76,17,5,272,3840,4
9,119,99,20,5,91,75,16,5,272,3840,4
10,107,94,13,5,94,79,15,5,272,3840,4
1,91,79,12,5,89,74,15,5,255,211,4
2,120,96,24,5,93,77,16,5,255,211,4
3,121,104,17,5,93,75,18,5,255,211,4
4,130,107,23,5,101,78,23,5,255,211,4
5,117,92,25,5,93,73,20,5,255,211,4
6,110,92,18,5,89,75,14,5,255,211,4
7,90,72,18,5,87,74,13,5,255,211,4
8,89,72,17,5,93,77,16,5,255,211,4
9,104,85,19,5,88,77,11,5,255,211,4
10,110,93,17,5,92,76,16,5,255,211,4
1,58,37,21,5,82,60,22,5,429,3086,4
2,63,40,23,5,85,66,19,5,429,3086,4
3,65,41,24,5,77,61,16,5,429,3086,4
4,56,35,21,5,74,62,12,5,429,3086,4
5,55,35,20,5,64,51,13,5,429,3086,4
6,50,36,14,5,80,62,18,5,429,3086,4
7,49,30,19,5,76,57,19,5,429,3086,4
8,55,33,22,5,67,51,16,5,429,3086,4
9,54,32,22,5,69,54,15,5,429,3086,4
10,44,30,14,5,64,51,13,5,429,3086,4
1,98,79,19,5,90,75,15,5,208,2797,4
2,101,85,16,5,94,78,16,5,208,2797,4
3,119,100,19,5,92,76,16,5,208,2797,4
4,119,98,21,5,96,77,19,5,208,2797,4
5,121,96,25,5,92,77,15,5,208,2797,4
6,113,95,18,5,89,74,15,5,208,2797,4
7,89,73,16,5,89,75,14,5,208,2797,4
8,105,82,23,5,97,75,22,5,208,2797,4
9,99,86,13,5,94,78,16,5,208,2797,4
10,114,94,20,5,91,77,14,5,208,2797,4
1,68,47,21,5,75,58,17,5,315,1809,4
2,69,47,22,5,76,61,15,5,315,1809,4
3,78,51,27,5,75,62,13,5,315,1809,4
4,71,45,26,5,85,67,18,5,315,1809,4
5,52,37,15,5,79,61,18,5,315,1809,4
6,61,38,23,5,65,55,10,5,315,1809,4
7,68,49,19,5,70,53,17,5,315,1809,4
8,50,34,16,5,81,61,20,5,315,1809,4
9,50,36,14,5,65,51,14,5,315,1809,4
10,55,38,17,5,81,60,21,5,315,1809,4
1,98,79,19,5,90,75,15,5,237,1464,4
2,101,85,16,5,94,78,16,5,237,1464,4
3,119,100,19,5,92,76,16,5,237,1464,4
4,119,98,21,5,96,77,19,5,237,1464,4
5,121,96,25,5,92,77,15,5,237,1464,4
6,113,95,18,5,89,74,15,5,237,1464,4
7,89,73,16,5,89,75,14,5,237,1464,4
8,105,82,23,5,97,75,22,5,237,1464,4
9,99,86,13,5,94,78,16,5,237,1464,4
10,114,94,20,5,91,77,14,5,237,1464,4
1,98,79,19,5,90,75,15,5,181,3590,4
2,101,85,16,5,94,78,16,5,181,3590,4
3,119,100,19,5,92,76,16,5,181,3590,4
4,119,98,21,5,96,77,19,5,181,3590,4
5,121,96,25,5,92,77,15,5,181,3590,4
6,113,95,18,5,89,74,15,5,181,3590,4
7,89,73,16,5,89,75,14,5,181,3590,4
8,105,82,23,5,97,75,22,5,181,3590,4
9,99,86,13,5,94,78,16,5,181,3590,4
10,114,94,20,5,91,77,14,5,181,3590,4
1,96,71,25,5,100,82,18,5,270,1872,4
2,94,70,24,5,104,80,24,5,270,1872,4
3,94,70,24,5,101,80,21,5,270,1872,4
4,95,69,26,5,102,81,21,5,270,1872,4
5,94,68,26,5,105,84,21,5,270,1872,4
6,98,68,30,5,104,82,22,5,270,1872,4
7,96,69,27,5,98,81,17,5,270,1872,4
8,95,66,29,5,102,83,19,5,270,1872,4
9,99,71,28,5,100,87,13,5,270,1872,4
10,100,69,31,5,98,84,14,5,270,1872,4
1,96,71,25,5,100,82,18,5,7,993,4
2,94,70,24,5,104,80,24,5,7,993,4
3,94,70,24,5,101,80,21,5,7,993,4
4,95,69,26,5,102,81,21,5,7,993,4
5,94,68,26,5,105,84,21,5,7,993,4
6,98,68,30,5,104,82,22,5,7,993,4
7,96,69,27,5,98,81,17,5,7,993,4
8,95,66,29,5,102,83,19,5,7,993,4
9,99,71,28,5,100,87,13,5,7,993,4
10,100,69,31,5,98,84,14,5,7,993,4
1,57,42,15,5,78,63,15,5,317,3500,4
2,68,50,18,5,75,58,17,5,317,3500,4
3,69,46,23,5,74,60,14,5,317,3500,4
4,67,45,22,5,101,74,27,5,317,3500,4
5,52,35,17,5,62,46,16,5,317,3500,4
6,55,35,20,5,77,58,19,5,317,3500,4
7,66,42,24,5,57,46,11,5,317,3500,4
8,52,35,17,5,68,52,16,5,317,3500,4
9,57,37,20,5,70,58,12,5,317,3500,4
10,59,37,22,5,76,59,17,5,317,3500,4
1,98,79,19,5,90,75,15,5,162,1153,4
2,101,85,16,5,94,78,16,5,162,1153,4
3,119,100,19,5,92,76,16,5,162,1153,4
4,119,98,21,5,96,77,19,5,162,1153,4
5,121,96,25,5,92,77,15,5,162,1153,4
6,113,95,18,5,89,74,15,5,162,1153,4
7,89,73,16,5,89,75,14,5,162,1153,4
8,105,82,23,5,97,75,22,5,162,1153,4
9,99,86,13,5,94,78,16,5,162,1153,4
10,114,94,20,5,91,77,14,5,162,1153,4
1,91,79,12,5,89,74,15,5,200,1930,4
2,120,96,24,5,93,77,16,5,200,1930,4
3,121,104,17,5,93,75,18,5,200,1930,4
4,130,107,23,5,101,78,23,5,200,1930,4
5,117,92,25,5,93,73,20,5,200,1930,4
6,110,92,18,5,89,75,14,5,200,1930,4
7,90,72,18,5,87,74,13,5,200,1930,4
8,89,72,17,5,93,77,16,5,200,1930,4
9,104,85,19,5,88,77,11,5,200,1930,4
10,110,93,17,5,92,76,16,5,200,1930,4
1,68,48,20,5,65,54,11,5,397,3490,4
2,60,47,13,5,74,58,16,5,397,3490,4
3,67,44,23,5,82,64,18,5,397,3490,4
4,73,46,27,5,89,69,20,5,397,3490,4
5,49,32,17,5,78,64,14,5,397,3490,4
6,51,35,16,5,63,47,16,5,397,3490,4
7,54,36,18,5,72,54,18,5,397,3490,4
8,67,42,25,5,64,50,14,5,397,3490,4
9,54,36,18,5,62,48,14,5,397,3490,4
10,61,39,22,5,73,52,21,5,397,3490,4
1,56,42,14,5,75,59,16,5,289,3473,4
2,71,50,21,5,79,64,15,5,289,3473,4
3,65,42,23,5,70,53,17,5,289,3473,4
4,58,46,12,5,75,56,19,5,289,3473,4
5,69,46,23,5,63,51,12,5,289,3473,4
6,63,43,20,5,74,58,16,5,289,3473,4
7,73,50,23,5,106,81,25,5,289,3473,4
8,50,36,14,5,61,51,10,5,289,3473,4
9,66,44,22,5,66,48,18,5,289,3473,4
10,66,44,22,5,70,55,15,5,289,3473,4
1,98,79,19,5,90,75,15,5,107,2530,4
2,101,85,16,5,94,78,16,5,107,2530,4
3,119,100,19,5,92,76,16,5,107,2530,4
4,119,98,21,5,96,77,19,5,107,2530,4
5,121,96,25,5,92,77,15,5,107,2530,4
6,113,95,18,5,89,74,15,5,107,2530,4
7,89,73,16,5,89,75,14,5,107,2530,4
8,105,82,23,5,97,75,22,5,107,2530,4
9,99,86,13,5,94,78,16,5,107,2530,4
10,114,94,20,5,91,77,14,5,107,2530,4
1,98,79,19,5,90,75,15,5,132,31,4
2,101,85,16,5,94,78,16,5,132,31,4
3,119,100,19,5,92,76,16,5,132,31,4
4,119,98,21,5,96,77,19,5,132,31,4
5,121,96,25,5,92,77,15,5,132,31,4
6,113,95,18,5,89,74,15,5,132,31,4
7,89,73,16,5,89,75,14,5,132,31,4
8,105,82,23,5,97,75,22,5,132,31,4
9,99,86,13,5,94,78,16,5,132,31,4
10,114,94,20,5,91,77,14,5,132,31,4
1,53,38,15,5,81,67,14,5,446,478,4
2,64,39,25,5,67,51,16,5,446,478,4
3,60,38,22,5,81,63,18,5,446,478,4
4,60,39,21,5,69,56,13,5,446,478,4
5,46,32,14,5,69,55,14,5,446,478,4
6,77,46,31,5,68,50,18,5,446,478,4
7,51,33,18,5,66,55,11,5,446,478,4
8,49,29,20,5,71,53,18,5,446,478,4
9,40,28,12,5,79,60,19,5,446,478,4
10,57,36,21,5,80,59,21,5,446,478,4
1,55,39,16,5,80,63,17,5,377,2986,4
2,75,46,29,5,71,58,13,5,377,2986,4
3,54,39,15,5,66,51,15,5,377,2986,4
4,56,38,18,5,70,59,11,5,377,2986,4
5,72,43,29,5,72,59,13,5,377,2986,4
6,49,34,15,5,78,58,20,5,377,2986,4
7,49,31,18,5,77,62,15,5,377,2986,4
8,54,31,23,5,69,51,18,5,377,2986,4
9,54,31,23,5,69,51,18,5,377,2986,4
10,53,34,19,5,87,65,22,5,377,2986,4
1,98,79,19,5,90,75,15,5,184,1849,4
2,101,85,16,5,94,78,16,5,184,1849,4
3,119,100,19,5,92,76,16,5,184,1849,4
4,119,98,21,5,96,77,19,5,184,1849,4
5,121,96,25,5,92,77,15,5,184,1849,4
6,113,95,18,5,89,74,15,5,184,1849,4
7,89,73,16,5,89,75,14,5,184,1849,4
8,105,82,23,5,97,75,22,5,184,1849,4
9,99,86,13,5,94,78,16,5,184,1849,4
10,114,94,20,5,91,77,14,5,184,1849,4
1,52,37,15,5,59,47,12,5,458,1653,4
2,66,40,26,5,73,59,14,5,458,1653,4
3,55,37,18,5,67,54,13,5,458,1653,4
4,46,34,12,5,74,60,14,5,458,1653,4
5,48,32,16,5,71,60,11,5,458,1653,4
6,59,39,20,5,62,51,11,5,458,1653,4
7,53,32,21,5,93,69,24,5,458,1653,4
8,55,32,23,5,84,63,21,5,458,1653,4
9,59,35,24,5,94,69,25,5,458,1653,4
10,60,36,24,5,79,61,18,5,458,1653,4
1,98,79,19,5,90,75,15,5,32,89,4
2,101,85,16,5,94,78,16,5,32,89,4
3,119,100,19,5,92,76,16,5,32,89,4
4,119,98,21,5,96,77,19,5,32,89,4
5,121,96,25,5,92,77,15,5,32,89,4
6,113,95,18,5,89,74,15,5,32,89,4
7,89,73,16,5,89,75,14,5,32,89,4
8,105,82,23,5,97,75,22,5,32,89,4
9,99,86,13,5,94,78,16,5,32,89,4
10,114,94,20,5,91,77,14,5,32,89,4
