RNTIs_DL,numDLTotal,numDLnew,numReTx_DL,avgMCS_DL,numULTotal,numULnew,numReTx_UL,avgMCS_UL,PulseWidth,PulseWidthSlotIdx,TTI
1,120,71,49,5,95,62,33,5,434,2622,2
2,128,72,56,5,89,56,33,5,434,2622,2
3,125,74,51,5,85,54,31,5,434,2622,2
4,132,73,59,5,102,66,36,5,434,2622,2
5,131,69,62,5,89,59,30,5,434,2622,2
6,134,74,60,5,85,55,30,5,434,2622,2
7,134,74,60,5,87,58,29,5,434,2622,2
8,133,75,58,5,94,62,32,5,434,2622,2
9,129,75,54,5,97,64,33,5,434,2622,2
10,127,74,53,5,84,56,28,5,434,2622,2
1,164,128,36,5,174,144,30,5,190,2937,2
2,162,130,32,5,178,148,30,5,190,2937,2
3,170,126,44,5,168,135,33,5,190,2937,2
4,169,126,43,5,177,144,33,5,190,2937,2
5,167,128,39,5,146,116,30,5,190,2937,2
6,171,127,44,5,141,111,30,5,190,2937,2
7,168,123,45,5,147,119,28,5,190,2937,2
8,167,128,39,5,140,115,25,5,190,2937,2
9,171,129,42,5,129,111,18,5,190,2937,2
10,169,123,46,5,178,147,31,5,190,2937,2
1,120,58,62,5,101,61,40,5,483,1665,2
2,123,59,64,5,92,60,32,5,483,1665,2
3,122,60,62,5,98,61,37,5,483,1665,2
4,123,60,63,5,91,60,31,5,483,1665,2
5,119,58,61,5,69,47,22,5,483,1665,2
6,123,58,65,5,93,61,32,5,483,1665,2
7,108,61,47,5,99,65,34,5,483,1665,2
8,115,60,55,5,84,57,27,5,483,1665,2
9,115,59,56,5,90,63,27,5,483,1665,2
10,115,57,58,5,94,61,33,5,483,1665,2
1,196,161,35,5,212,191,21,5,7,722,2
2,196,162,34,5,215,188,27,5,7,722,2
3,193,162,31,5,211,190,21,5,7,722,2
4,195,162,33,5,214,192,22,5,7,722,2
5,196,166,30,5,216,190,26,5,7,722,2
6,203,166,37,5,210,187,23,5,7,722,2
7,196,162,34,5,210,191,19,5,7,722,2
8,197,168,29,5,211,190,21,5,7,722,2
9,196,165,31,5,210,189,21,5,7,722,2
10,194,163,31,5,209,188,21,5,7,722,2
1,137,92,45,5,91,70,21,5,297,2352,2
2,141,88,53,5,98,76,22,5,297,2352,2
3,139,90,49,5,139,105,34,5,297,2352,2
4,143,90,53,5,111,82,29,5,297,2352,2
5,137,92,45,5,131,95,36,5,297,2352,2
6,150,90,60,5,120,88,32,5,297,2352,2
7,147,90,57,5,117,86,31,5,297,2352,2
8,144,89,55,5,87,63,24,5,297,2352,2
9,142,91,51,5,112,80,32,5,297,2352,2
10,141,92,49,5,135,97,38,5,297,2352,2
1,196,161,35,5,207,190,17,5,122,3471,2
2,196,164,32,5,215,194,21,5,122,3471,2
3,194,160,34,5,208,192,16,5,122,3471,2
4,197,165,32,5,211,191,20,5,122,3471,2
5,195,164,31,5,209,189,20,5,122,3471,2
6,197,161,36,5,210,190,20,5,122,3471,2
7,196,164,32,5,207,188,19,5,122,3471,2
8,195,162,33,5,212,189,23,5,122,3471,2
9,194,158,36,5,207,187,20,5,122,3471,2
10,194,164,30,5,204,190,14,5,122,3471,2
1,169,124,45,5,126,104,22,5,185,1165,2
2,168,127,41,5,143,119,24,5,185,1165,2
3,160,127,33,5,160,133,27,5,185,1165,2
4,164,121,43,5,181,145,36,5,185,1165,2
5,165,123,42,5,182,147,35,5,185,1165,2
6,166,126,40,5,162,132,30,5,185,1165,2
7,170,123,47,5,160,126,34,5,185,1165,2
8,170,126,44,5,155,129,26,5,185,1165,2
9,167,124,43,5,158,130,28,5,185,1165,2
10,167,125,42,5,138,112,26,5,185,1165,2
1,140,85,55,5,128,88,40,5,319,1807,2
2,147,87,60,5,122,91,31,5,319,1807,2
3,142,87,55,5,87,68,19,5,319,1807,2
4,143,88,55,5,127,94,33,5,319,1807,2
5,137,88,49,5,117,89,28,5,319,1807,2
6,132,87,45,5,108,80,28,5,319,1807,2
7,139,87,52,5,126,94,32,5,319,1807,2
8,134,85,49,5,89,65,24,5,319,1807,2
9,146,88,58,5,110,81,29,5,319,1807,2
10,146,84,62,5,112,80,32,5,319,1807,2
1,196,161,35,5,207,190,17,5,105,1856,2
2,196,164,32,5,215,194,21,5,105,1856,2
3,194,160,34,5,208,192,16,5,105,1856,2
4,197,165,32,5,211,191,20,5,105,1856,2
5,195,164,31,5,209,189,20,5,105,1856,2
6,197,161,36,5,210,190,20,5,105,1856,2
7,196,164,32,5,207,188,19,5,105,1856,2
8,195,162,33,5,212,189,23,5,105,1856,2
9,194,158,36,5,207,187,20,5,105,1856,2
10,194,164,30,5,204,190,14,5,105,1856,2
1,137,68,69,5,97,64,33,5,470,2880,2
2,140,71,69,5,116,66,50,5,470,2880,2
3,144,72,72,5,113,69,44,5,470,2880,2
4,150,73,77,5,123,81,42,5,470,2880,2
5,142,73,69,5,116,70,46,5,470,2880,2
6,144,68,76,5,114,67,47,5,470,2880,2
7,134,69,65,5,125,78,47,5,470,2880,2
8,140,73,67,5,124,71,53,5,470,2880,2
9,144,69,75,5,105,67,38,5,470,2880,2
10,155,73,82,5,114,77,37,5,470,2880,2
1,196,161,35,5,207,190,17,5,14,1431,2
2,196,164,32,5,215,194,21,5,14,1431,2
3,194,160,34,5,208,192,16,5,14,1431,2
4,197,165,32,5,211,191,20,5,14,1431,2
5,195,164,31,5,209,189,20,5,14,1431,2
6,197,161,36,5,210,190,20,5,14,1431,2
7,196,164,32,5,207,188,19,5,14,1431,2
8,195,162,33,5,212,189,23,5,14,1431,2
9,194,158,36,5,207,187,20,5,14,1431,2
10,194,164,30,5,204,190,14,5,14,1431,2
1,129,73,56,5,107,75,32,5,391,62,2
2,126,73,53,5,104,75,29,5,391,62,2
3,129,71,58,5,97,70,27,5,391,62,2
4,131,73,58,5,109,79,30,5,391,62,2
5,134,74,60,5,104,81,23,5,391,62,2
6,128,76,52,5,95,73,22,5,391,62,2
7,129,77,52,5,116,82,34,5,391,62,2
8,128,72,56,5,116,86,30,5,391,62,2
9,127,72,55,5,121,89,32,5,391,62,2
10,126,74,52,5,121,91,30,5,391,62,2
1,125,76,49,5,101,74,27,5,353,1964,2
2,129,81,48,5,108,76,32,5,353,1964,2
3,127,80,47,5,130,97,33,5,353,1964,2
4,138,78,60,5,99,77,22,5,353,1964,2
5,137,79,58,5,118,88,30,5,353,1964,2
6,138,77,61,5,106,82,24,5,353,1964,2
7,131,76,55,5,123,94,29,5,353,1964,2
8,138,79,59,5,118,86,32,5,353,1964,2
9,127,77,50,5,133,98,35,5,353,1964,2
10,133,75,58,5,115,81,34,5,353,1964,2
1,176,133,43,5,156,128,28,5,166,1751,2
2,166,134,32,5,146,120,26,5,166,1751,2
3,166,135,31,5,192,153,39,5,166,1751,2
4,178,131,47,5,119,98,21,5,166,1751,2
5,170,132,38,5,183,148,35,5,166,1751,2
6,172,129,43,5,134,111,23,5,166,1751,2
7,170,130,40,5,130,104,26,5,166,1751,2
8,170,133,37,5,171,141,30,5,166,1751,2
9,176,129,47,5,167,137,30,5,166,1751,2
10,174,130,44,5,163,133,30,5,166,1751,2
1,122,71,51,5,100,63,37,5,489,2643,2
2,130,70,60,5,89,57,32,5,489,2643,2
3,129,73,56,5,97,61,36,5,489,2643,2
4,123,72,51,5,83,55,28,5,489,2643,2
5,126,73,53,5,75,51,24,5,489,2643,2
6,135,74,61,5,79,51,28,5,489,2643,2
7,130,70,60,5,96,61,35,5,489,2643,2
8,125,73,52,5,89,60,29,5,489,2643,2
9,124,66,58,5,101,67,34,5,489,2643,2
10,132,67,65,5,84,55,29,5,489,2643,2
1,173,115,58,5,140,95,45,5,340,697,2
2,171,108,63,5,145,102,43,5,340,697,2
3,165,112,53,5,142,104,38,5,340,697,2
4,178,112,66,5,168,115,53,5,340,697,2
5,167,114,53,5,135,99,36,5,340,697,2
6,177,115,62,5,125,91,34,5,340,697,2
7,175,111,64,5,154,112,42,5,340,697,2
8,167,110,57,5,148,99,49,5,340,697,2
9,167,111,56,5,139,97,42,5,340,697,2
10,173,108,65,5,142,93,49,5,340,697,2
1,147,99,48,5,112,87,25,5,429,935,2
2,154,99,55,5,84,58,26,5,429,935,2
3,141,98,43,5,108,76,32,5,429,935,2
4,144,98,46,5,118,89,29,5,429,935,2
5,144,96,48,5,101,80,21,5,429,935,2
6,148,92,56,5,106,79,27,5,429,935,2
7,149,99,50,5,127,94,33,5,429,935,2
8,149,96,53,5,136,99,37,5,429,935,2
9,148,89,59,5,124,90,34,5,429,935,2
10,146,92,54,5,123,88,35,5,429,935,2
1,133,78,55,5,110,76,34,5,428,1910,2
2,141,83,58,5,120,84,36,5,428,1910,2
3,142,80,62,5,114,82,32,5,428,1910,2
4,137,81,56,5,126,90,36,5,428,1910,2
5,135,81,54,5,105,80,25,5,428,1910,2
6,136,84,52,5,114,87,27,5,428,1910,2
7,130,80,50,5,111,82,29,5,428,1910,2
8,130,78,52,5,119,89,30,5,428,1910,2
9,128,77,51,5,113,82,31,5,428,1910,2
10,130,82,48,5,105,78,27,5,428,1910,2
1,148,96,52,5,103,76,27,5,290,108,2
2,153,97,56,5,113,83,30,5,290,108,2
3,144,96,48,5,79,64,15,5,290,108,2
4,154,93,61,5,122,91,31,5,290,108,2
5,141,92,49,5,106,78,28,5,290,108,2
6,150,94,56,5,115,85,30,5,290,108,2
7,149,96,53,5,126,96,30,5,290,108,2
8,137,94,43,5,110,74,36,5,290,108,2
9,140,92,48,5,126,87,39,5,290,108,2
10,150,91,59,5,114,86,28,5,290,108,2
1,196,161,35,5,207,190,17,5,94,307,2
2,196,164,32,5,215,194,21,5,94,307,2
3,194,160,34,5,208,192,16,5,94,307,2
4,197,165,32,5,211,191,20,5,94,307,2
5,195,164,31,5,209,189,20,5,94,307,2
6,197,161,36,5,210,190,20,5,94,307,2
7,196,164,32,5,207,188,19,5,94,307,2
8,195,162,33,5,212,189,23,5,94,307,2
9,194,158,36,5,207,187,20,5,94,307,2
10,194,164,30,5,204,190,14,5,94,307,2
1,180,135,45,5,138,113,25,5,195,2755,2
2,180,136,44,5,147,119,28,5,195,2755,2
3,175,137,38,5,141,120,21,5,195,2755,2
4,176,131,45,5,180,144,36,5,195,2755,2
5,174,130,44,5,182,148,34,5,195,2755,2
6,173,135,38,5,155,127,28,5,195,2755,2
7,172,132,40,5,152,126,26,5,195,2755,2
8,174,132,42,5,163,136,27,5,195,2755,2
9,176,136,40,5,151,118,33,5,195,2755,2
10,177,135,42,5,153,123,30,5,195,2755,2
1,196,161,35,5,207,190,17,5,90,1720,2
2,196,164,32,5,215,194,21,5,90,1720,2
3,194,160,34,5,208,192,16,5,90,1720,2
4,197,165,32,5,211,191,20,5,90,1720,2
5,195,164,31,5,209,189,20,5,90,1720,2
6,197,161,36,5,210,190,20,5,90,1720,2
7,196,164,32,5,207,188,19,5,90,1720,2
8,195,162,33,5,212,189,23,5,90,1720,2
9,194,158,36,5,207,187,20,5,90,1720,2
10,194,164,30,5,204,190,14,5,90,1720,2
1,195,136,59,5,157,129,28,5,269,3233,2
2,188,134,54,5,164,132,32,5,269,3233,2
3,193,138,55,5,164,129,35,5,269,3233,2
4,191,143,48,5,168,135,33,5,269,3233,2
5,192,136,56,5,172,129,43,5,269,3233,2
6,192,139,53,5,162,124,38,5,269,3233,2
7,187,130,57,5,171,130,41,5,269,3233,2
8,186,139,47,5,174,130,44,5,269,3233,2
9,189,142,47,5,165,130,35,5,269,3233,2
10,184,139,45,5,164,128,36,5,269,3233,2
1,196,161,35,5,207,190,17,5,46,1259,2
2,196,164,32,5,215,194,21,5,46,1259,2
3,194,160,34,5,208,192,16,5,46,1259,2
4,197,165,32,5,211,191,20,5,46,1259,2
5,195,164,31,5,209,189,20,5,46,1259,2
6,197,161,36,5,210,190,20,5,46,1259,2
7,196,164,32,5,207,188,19,5,46,1259,2
8,195,162,33,5,212,189,23,5,46,1259,2
9,194,158,36,5,207,187,20,5,46,1259,2
10,194,164,30,5,204,190,14,5,46,1259,2
1,124,81,43,5,107,73,34,5,357,255,2
2,127,82,45,5,125,92,33,5,357,255,2
3,131,80,51,5,119,85,34,5,357,255,2
4,136,80,56,5,115,87,28,5,357,255,2
5,137,76,61,5,110,87,23,5,357,255,2
6,134,79,55,5,111,80,31,5,357,255,2
7,139,80,59,5,107,83,24,5,357,255,2
8,135,80,55,5,119,88,31,5,357,255,2
9,133,84,49,5,114,82,32,5,357,255,2
10,137,76,61,5,98,73,25,5,357,255,2
1,141,94,47,5,131,94,37,5,336,1342,2
2,149,92,57,5,86,60,26,5,336,1342,2
3,136,90,46,5,127,93,34,5,336,1342,2
4,148,92,56,5,120,86,34,5,336,1342,2
5,143,91,52,5,122,89,33,5,336,1342,2
6,145,94,51,5,117,91,26,5,336,1342,2
7,149,91,58,5,98,73,25,5,336,1342,2
8,147,92,55,5,120,93,27,5,336,1342,2
9,150,92,58,5,101,74,27,5,336,1342,2
10,143,92,51,5,100,72,28,5,336,1342,2
1,196,161,35,5,207,190,17,5,48,156,2
2,196,164,32,5,215,194,21,5,48,156,2
3,194,160,34,5,208,192,16,5,48,156,2
4,197,165,32,5,211,191,20,5,48,156,2
5,195,164,31,5,209,189,20,5,48,156,2
6,197,161,36,5,210,190,20,5,48,156,2
7,196,164,32,5,207,188,19,5,48,156,2
8,195,162,33,5,212,189,23,5,48,156,2
9,194,158,36,5,207,187,20,5,48,156,2
10,194,164,30,5,204,190,14,5,48,156,2
1,127,75,52,5,103,73,30,5,423,958,2
2,128,76,52,5,116,80,36,5,423,958,2
3,137,73,64,5,118,86,32,5,423,958,2
4,127,75,52,5,114,86,28,5,423,958,2
5,129,76,53,5,133,101,32,5,423,958,2
6,127,77,50,5,110,80,30,5,423,958,2
7,137,80,57,5,106,82,24,5,423,958,2
8,129,76,53,5,106,84,22,5,423,958,2
9,127,71,56,5,118,82,36,5,423,958,2
10,132,77,55,5,118,87,31,5,423,958,2
1,196,161,35,5,207,190,17,5,64,103,2
2,196,164,32,5,215,194,21,5,64,103,2
3,194,160,34,5,208,192,16,5,64,103,2
4,197,165,32,5,211,191,20,5,64,103,2
5,195,164,31,5,209,189,20,5,64,103,2
6,197,161,36,5,210,190,20,5,64,103,2
7,196,164,32,5,207,188,19,5,64,103,2
8,195,162,33,5,212,189,23,5,64,103,2
9,194,158,36,5,207,187,20,5,64,103,2
10,194,164,30,5,204,190,14,5,64,103,2
1,196,161,35,5,207,190,17,5,144,1365,2
2,196,164,32,5,215,194,21,5,144,1365,2
3,194,160,34,5,208,192,16,5,144,1365,2
4,197,165,32,5,211,191,20,5,144,1365,2
5,195,164,31,5,209,189,20,5,144,1365,2
6,197,161,36,5,210,190,20,5,144,1365,2
7,196,164,32,5,207,188,19,5,144,1365,2
8,195,162,33,5,212,189,23,5,144,1365,2
9,194,158,36,5,207,187,20,5,144,1365,2
10,194,164,30,5,204,190,14,5,144,1365,2
1,139,88,51,5,114,80,34,5,397,2958,2
2,146,85,61,5,81,55,26,5,397,2958,2
3,138,87,51,5,84,65,19,5,397,2958,2
4,147,86,61,5,97,73,24,5,397,2958,2
5,137,88,49,5,134,105,29,5,397,2958,2
6,143,86,57,5,113,78,35,5,397,2958,2
7,136,88,48,5,106,78,28,5,397,2958,2
8,143,85,58,5,117,86,31,5,397,2958,2
9,139,85,54,5,126,91,35,5,397,2958,2
10,134,88,46,5,110,78,32,5,397,2958,2
1,107,65,42,5,86,58,28,5,492,3005,2
2,124,64,60,5,88,60,28,5,492,3005,2
3,122,66,56,5,85,54,31,5,492,3005,2
4,119,66,53,5,82,56,26,5,492,3005,2
5,126,64,62,5,95,57,38,5,492,3005,2
6,127,65,62,5,83,55,28,5,492,3005,2
7,122,63,59,5,99,61,38,5,492,3005,2
8,125,63,62,5,85,56,29,5,492,3005,2
9,123,63,60,5,97,64,33,5,492,3005,2
10,123,63,60,5,95,63,32,5,492,3005,2
1,196,161,35,5,207,190,17,5,118,1293,2
2,196,164,32,5,215,194,21,5,118,1293,2
3,194,160,34,5,208,192,16,5,118,1293,2
4,197,165,32,5,211,191,20,5,118,1293,2
5,195,164,31,5,209,189,20,5,118,1293,2
6,197,161,36,5,210,190,20,5,118,1293,2
7,196,164,32,5,207,188,19,5,118,1293,2
8,195,162,33,5,212,189,23,5,118,1293,2
9,194,158,36,5,207,187,20,5,118,1293,2
10,194,164,30,5,204,190,14,5,118,1293,2
1,138,72,66,5,126,81,45,5,472,621,2
2,141,70,71,5,121,76,45,5,472,621,2
3,135,70,65,5,112,68,44,5,472,621,2
4,152,70,82,5,110,67,43,5,472,621,2
5,141,74,67,5,103,64,39,5,472,621,2
6,141,72,69,5,99,60,39,5,472,621,2
7,141,72,69,5,124,79,45,5,472,621,2
8,150,71,79,5,130,77,53,5,472,621,2
9,141,68,73,5,122,75,47,5,472,621,2
10,148,69,79,5,93,60,33,5,472,621,2
1,162,123,39,5,142,113,29,5,180,1407,2
2,163,122,41,5,141,115,26,5,180,1407,2
3,163,124,39,5,132,107,25,5,180,1407,2
4,164,127,37,5,142,115,27,5,180,1407,2
5,166,125,41,5,154,127,27,5,180,1407,2
6,169,122,47,5,182,150,32,5,180,1407,2
7,169,127,42,5,171,143,28,5,180,1407,2
8,159,124,35,5,173,145,28,5,180,1407,2
9,172,122,50,5,141,113,28,5,180,1407,2
10,168,120,48,5,188,150,38,5,180,1407,2
1,115,59,56,5,103,65,38,5,437,2541,2
2,118,62,56,5,92,60,32,5,437,2541,2
3,122,62,60,5,82,54,28,5,437,2541,2
4,115,64,51,5,92,63,29,5,437,2541,2
5,113,64,49,5,92,58,34,5,437,2541,2
6,125,64,61,5,93,57,36,5,437,2541,2
7,122,63,59,5,86,60,26,5,437,2541,2
8,122,62,60,5,90,60,30,5,437,2541,2
9,119,59,60,5,95,63,32,5,437,2541,2
10,131,60,71,5,83,56,27,5,437,2541,2
1,196,161,35,5,207,190,17,5,45,1790,2
2,196,164,32,5,215,194,21,5,45,1790,2
3,194,160,34,5,208,192,16,5,45,1790,2
4,197,165,32,5,211,191,20,5,45,1790,2
5,195,164,31,5,209,189,20,5,45,1790,2
6,197,161,36,5,210,190,20,5,45,1790,2
7,196,164,32,5,207,188,19,5,45,1790,2
8,195,162,33,5,212,189,23,5,45,1790,2
9,194,158,36,5,207,187,20,5,45,1790,2
10,194,164,30,5,204,190,14,5,45,1790,2
1,196,161,35,5,207,190,17,5,81,2213,2
2,196,164,32,5,215,194,21,5,81,2213,2
3,194,160,34,5,208,192,16,5,81,2213,2
4,197,165,32,5,211,191,20,5,81,2213,2
5,195,164,31,5,209,189,20,5,81,2213,2
6,197,161,36,5,210,190,20,5,81,2213,2
7,196,164,32,5,207,188,19,5,81,2213,2
8,195,162,33,5,212,189,23,5,81,2213,2
9,194,158,36,5,207,187,20,5,81,2213,2
10,194,164,30,5,204,190,14,5,81,2213,2
1,120,67,53,5,73,48,25,5,448,998,2
2,117,68,49,5,104,66,38,5,448,998,2
3,126,68,58,5,100,63,37,5,448,998,2
4,127,64,63,5,100,65,35,5,448,998,2
5,126,65,61,5,93,59,34,5,448,998,2
6,136,67,69,5,96,59,37,5,448,998,2
7,127,67,60,5,78,57,21,5,448,998,2
8,115,65,50,5,86,58,28,5,448,998,2
9,129,66,63,5,94,63,31,5,448,998,2
10,124,67,57,5,85,55,30,5,448,998,2
1,175,130,45,5,146,118,28,5,209,2458,2
2,174,129,45,5,131,106,25,5,209,2458,2
3,175,133,42,5,183,146,37,5,209,2458,2
4,172,125,47,5,116,97,19,5,209,2458,2
5,170,132,38,5,164,131,33,5,209,2458,2
6,172,130,42,5,168,142,26,5,209,2458,2
7,169,131,38,5,140,108,32,5,209,2458,2
8,166,132,34,5,185,151,34,5,209,2458,2
9,173,131,42,5,155,133,22,5,209,2458,2
10,172,126,46,5,174,142,32,5,209,2458,2
1,196,161,35,5,207,190,17,5,28,1820,2
2,196,164,32,5,215,194,21,5,28,1820,2
3,194,160,34,5,208,192,16,5,28,1820,2
4,197,165,32,5,211,191,20,5,28,1820,2
5,195,164,31,5,209,189,20,5,28,1820,2
6,197,161,36,5,210,190,20,5,28,1820,2
7,196,164,32,5,207,188,19,5,28,1820,2
8,195,162,33,5,212,189,23,5,28,1820,2
9,194,158,36,5,207,187,20,5,28,1820,2
10,194,164,30,5,204,190,14,5,28,1820,2
1,192,133,59,5,163,131,32,5,261,1659,2
2,187,131,56,5,168,134,34,5,261,1659,2
3,183,132,51,5,170,127,43,5,261,1659,2
4,176,134,42,5,169,130,39,5,261,1659,2
5,187,129,58,5,166,133,33,5,261,1659,2
6,186,128,58,5,162,128,34,5,261,1659,2
7,182,133,49,5,169,133,36,5,261,1659,2
8,182,130,52,5,169,131,38,5,261,1659,2
9,181,129,52,5,164,129,35,5,261,1659,2
10,188,130,58,5,170,132,38,5,261,1659,2
1,124,76,48,5,104,77,27,5,388,2850,2
2,127,79,48,5,139,97,42,5,388,2850,2
3,130,77,53,5,95,65,30,5,388,2850,2
4,134,76,58,5,109,79,30,5,388,2850,2
5,135,78,57,5,113,88,25,5,388,2850,2
6,133,76,57,5,109,82,27,5,388,2850,2
7,138,79,59,5,98,76,22,5,388,2850,2
8,129,80,49,5,113,85,28,5,388,2850,2
9,134,77,57,5,108,76,32,5,388,2850,2
10,131,78,53,5,117,87,30,5,388,2850,2
1,145,99,46,5,135,99,36,5,307,2858,2
2,154,98,56,5,100,75,25,5,307,2858,2
3,155,101,54,5,115,82,33,5,307,2858,2
4,149,100,49,5,113,80,33,5,307,2858,2
5,153,96,57,5,97,74,23,5,307,2858,2
6,151,97,54,5,118,84,34,5,307,2858,2
7,145,96,49,5,100,75,25,5,307,2858,2
8,149,98,51,5,99,76,23,5,307,2858,2
9,148,101,47,5,130,97,33,5,307,2858,2
10,146,98,48,5,125,92,33,5,307,2858,2
1,196,161,35,5,207,190,17,5,109,1228,2
2,196,164,32,5,215,194,21,5,109,1228,2
3,194,160,34,5,208,192,16,5,109,1228,2
4,197,165,32,5,211,191,20,5,109,1228,2
5,195,164,31,5,209,189,20,5,109,1228,2
6,197,161,36,5,210,190,20,5,109,1228,2
7,196,164,32,5,207,188,19,5,109,1228,2
8,195,162,33,5,212,189,23,5,109,1228,2
9,194,158,36,5,207,187,20,5,109,1228,2
10,194,164,30,5,204,190,14,5,109,1228,2
1,137,92,45,5,91,70,21,5,297,956,2
2,141,88,53,5,98,76,22,5,297,956,2
3,139,90,49,5,139,105,34,5,297,956,2
4,143,90,53,5,111,82,29,5,297,956,2
5,137,92,45,5,131,95,36,5,297,956,2
6,150,90,60,5,120,88,32,5,297,956,2
7,147,90,57,5,117,86,31,5,297,956,2
8,144,89,55,5,87,63,24,5,297,956,2
9,142,91,51,5,112,80,32,5,297,956,2
10,141,92,49,5,135,97,38,5,297,956,2
1,196,161,35,5,207,190,17,5,66,247,2
2,196,164,32,5,215,194,21,5,66,247,2
3,194,160,34,5,208,192,16,5,66,247,2
4,197,165,32,5,211,191,20,5,66,247,2
5,195,164,31,5,209,189,20,5,66,247,2
6,197,161,36,5,210,190,20,5,66,247,2
7,196,164,32,5,207,188,19,5,66,247,2
8,195,162,33,5,212,189,23,5,66,247,2
9,194,158,36,5,207,187,20,5,66,247,2
10,194,164,30,5,204,190,14,5,66,247,2
1,196,161,35,5,207,190,17,5,129,553,2
2,196,164,32,5,215,194,21,5,129,553,2
3,194,160,34,5,208,192,16,5,129,553,2
4,197,165,32,5,211,191,20,5,129,553,2
5,195,164,31,5,209,189,20,5,129,553,2
6,197,161,36,5,210,190,20,5,129,553,2
7,196,164,32,5,207,188,19,5,129,553,2
8,195,162,33,5,212,189,23,5,129,553,2
9,194,158,36,5,207,187,20,5,129,553,2
10,194,164,30,5,204,190,14,5,129,553,2
1,177,127,50,5,169,133,36,5,246,1390,2
2,177,129,48,5,165,127,38,5,246,1390,2
3,183,126,57,5,170,133,37,5,246,1390,2
4,180,126,54,5,168,134,34,5,246,1390,2
5,179,127,52,5,164,131,33,5,246,1390,2
6,182,127,55,5,166,134,32,5,246,1390,2
7,178,126,52,5,166,131,35,5,246,1390,2
8,183,128,55,5,169,134,35,5,246,1390,2
9,179,127,52,5,170,128,42,5,246,1390,2
10,182,127,55,5,167,129,38,5,246,1390,2
1,132,82,50,5,114,85,29,5,399,142,2
2,135,81,54,5,89,59,30,5,399,142,2
3,138,86,52,5,128,93,35,5,399,142,2
4,142,84,58,5,124,93,31,5,399,142,2
5,140,82,58,5,124,90,34,5,399,142,2
6,139,87,52,5,142,103,39,5,399,142,2
7,141,79,62,5,105,78,27,5,399,142,2
8,136,83,53,5,98,71,27,5,399,142,2
9,134,83,51,5,116,94,22,5,399,142,2
10,136,83,53,5,115,90,25,5,399,142,2
1,165,133,32,5,183,150,33,5,189,1153,2
2,169,134,35,5,146,120,26,5,189,1153,2
3,174,131,43,5,185,149,36,5,189,1153,2
4,180,126,54,5,161,130,31,5,189,1153,2
5,175,131,44,5,151,121,30,5,189,1153,2
6,177,129,48,5,128,107,21,5,189,1153,2
7,174,128,46,5,151,121,30,5,189,1153,2
8,171,132,39,5,152,125,27,5,189,1153,2
9,177,129,48,5,173,141,32,5,189,1153,2
10,172,132,40,5,135,113,22,5,189,1153,2
1,196,161,35,5,207,190,17,5,40,1187,2
2,196,164,32,5,215,194,21,5,40,1187,2
3,194,160,34,5,208,192,16,5,40,1187,2
4,197,165,32,5,211,191,20,5,40,1187,2
5,195,164,31,5,209,189,20,5,40,1187,2
6,197,161,36,5,210,190,20,5,40,1187,2
7,196,164,32,5,207,188,19,5,40,1187,2
8,195,162,33,5,212,189,23,5,40,1187,2
9,194,158,36,5,207,187,20,5,40,1187,2
10,194,164,30,5,204,190,14,5,40,1187,2
1,176,133,43,5,156,128,28,5,166,2294,2
2,166,134,32,5,146,120,26,5,166,2294,2
3,166,135,31,5,192,153,39,5,166,2294,2
4,178,131,47,5,119,98,21,5,166,2294,2
5,170,132,38,5,183,148,35,5,166,2294,2
6,172,129,43,5,134,111,23,5,166,2294,2
7,170,130,40,5,130,104,26,5,166,2294,2
8,170,133,37,5,171,141,30,5,166,2294,2
9,176,129,47,5,167,137,30,5,166,2294,2
10,174,130,44,5,163,133,30,5,166,2294,2
1,144,70,74,5,122,78,44,5,478,2942,2
2,144,70,74,5,114,72,42,5,478,2942,2
3,148,70,78,5,123,76,47,5,478,2942,2
4,148,72,76,5,129,77,52,5,478,2942,2
5,136,74,62,5,116,72,44,5,478,2942,2
6,140,73,67,5,120,73,47,5,478,2942,2
7,143,72,71,5,116,72,44,5,478,2942,2
8,135,71,64,5,98,62,36,5,478,2942,2
9,151,74,77,5,104,66,38,5,478,2942,2
10,143,70,73,5,103,69,34,5,478,2942,2
1,166,133,33,5,164,133,31,5,249,1714,2
2,175,133,42,5,144,115,29,5,249,1714,2
3,180,131,49,5,136,111,25,5,249,1714,2
4,171,125,46,5,117,96,21,5,249,1714,2
5,169,131,38,5,154,127,27,5,249,1714,2
6,174,124,50,5,177,147,30,5,249,1714,2
7,167,128,39,5,162,135,27,5,249,1714,2
8,173,127,46,5,180,146,34,5,249,1714,2
9,172,126,46,5,174,144,30,5,249,1714,2
10,178,133,45,5,151,117,34,5,249,1714,2
1,168,122,46,5,165,139,26,5,197,1402,2
2,171,129,42,5,142,115,27,5,197,1402,2
3,167,128,39,5,160,130,30,5,197,1402,2
4,169,126,43,5,123,100,23,5,197,1402,2
5,166,126,40,5,153,122,31,5,197,1402,2
6,166,124,42,5,132,108,24,5,197,1402,2
7,167,130,37,5,191,153,38,5,197,1402,2
8,172,129,43,5,170,136,34,5,197,1402,2
9,174,131,43,5,179,150,29,5,197,1402,2
10,171,126,45,5,154,128,26,5,197,1402,2
1,178,123,55,5,169,133,36,5,247,3241,2
2,177,127,50,5,165,129,36,5,247,3241,2
3,181,124,57,5,168,130,38,5,247,3241,2
4,178,126,52,5,166,130,36,5,247,3241,2
5,176,126,50,5,164,131,33,5,247,3241,2
6,186,128,58,5,164,131,33,5,247,3241,2
7,181,129,52,5,167,128,39,5,247,3241,2
8,180,127,53,5,167,132,35,5,247,3241,2
9,182,128,54,5,165,128,37,5,247,3241,2
10,180,127,53,5,170,130,40,5,247,3241,2
1,196,161,35,5,207,190,17,5,111,1747,2
2,196,164,32,5,215,194,21,5,111,1747,2
3,194,160,34,5,208,192,16,5,111,1747,2
4,197,165,32,5,211,191,20,5,111,1747,2
5,195,164,31,5,209,189,20,5,111,1747,2
6,197,161,36,5,210,190,20,5,111,1747,2
7,196,164,32,5,207,188,19,5,111,1747,2
8,195,162,33,5,212,189,23,5,111,1747,2
9,194,158,36,5,207,187,20,5,111,1747,2
10,194,164,30,5,204,190,14,5,111,1747,2
1,165,127,38,5,177,148,29,5,186,2541,2
2,166,123,43,5,178,144,34,5,186,2541,2
3,162,121,41,5,155,124,31,5,186,2541,2
4,170,124,46,5,157,130,27,5,186,2541,2
5,164,124,40,5,157,129,28,5,186,2541,2
6,165,121,44,5,132,104,28,5,186,2541,2
7,166,127,39,5,139,111,28,5,186,2541,2
8,164,123,41,5,147,120,27,5,186,2541,2
9,167,121,46,5,157,129,28,5,186,2541,2
10,169,126,43,5,164,136,28,5,186,2541,2
1,176,131,45,5,129,107,22,5,157,3043,2
2,172,129,43,5,177,143,34,5,157,3043,2
3,173,132,41,5,134,108,26,5,157,3043,2
4,175,129,46,5,164,135,29,5,157,3043,2
5,173,133,40,5,151,123,28,5,157,3043,2
6,170,133,37,5,151,122,29,5,157,3043,2
7,172,132,40,5,170,140,30,5,157,3043,2
8,171,135,36,5,164,138,26,5,157,3043,2
9,177,135,42,5,173,140,33,5,157,3043,2
10,183,130,53,5,167,136,31,5,157,3043,2
1,196,161,35,5,207,190,17,5,25,3117,2
2,196,164,32,5,215,194,21,5,25,3117,2
3,194,160,34,5,208,192,16,5,25,3117,2
4,197,165,32,5,211,191,20,5,25,3117,2
5,195,164,31,5,209,189,20,5,25,3117,2
6,197,161,36,5,210,190,20,5,25,3117,2
7,196,164,32,5,207,188,19,5,25,3117,2
8,195,162,33,5,212,189,23,5,25,3117,2
9,194,158,36,5,207,187,20,5,25,3117,2
10,194,164,30,5,204,190,14,5,25,3117,2
1,195,136,59,5,157,129,28,5,269,2204,2
2,188,134,54,5,164,132,32,5,269,2204,2
3,193,138,55,5,164,129,35,5,269,2204,2
4,191,143,48,5,168,135,33,5,269,2204,2
5,192,136,56,5,172,129,43,5,269,2204,2
6,192,139,53,5,162,124,38,5,269,2204,2
7,187,130,57,5,171,130,41,5,269,2204,2
8,186,139,47,5,174,130,44,5,269,2204,2
9,189,142,47,5,165,130,35,5,269,2204,2
10,184,139,45,5,164,128,36,5,269,2204,2
1,196,161,35,5,207,190,17,5,18,2835,2
2,196,164,32,5,215,194,21,5,18,2835,2
3,194,160,34,5,208,192,16,5,18,2835,2
4,197,165,32,5,211,191,20,5,18,2835,2
5,195,164,31,5,209,189,20,5,18,2835,2
6,197,161,36,5,210,190,20,5,18,2835,2
7,196,164,32,5,207,188,19,5,18,2835,2
8,195,162,33,5,212,189,23,5,18,2835,2
9,194,158,36,5,207,187,20,5,18,2835,2
10,194,164,30,5,204,190,14,5,18,2835,2
1,144,96,48,5,114,83,31,5,301,2854,2
2,148,98,50,5,91,67,24,5,301,2854,2
3,139,95,44,5,133,99,34,5,301,2854,2
4,149,96,53,5,94,72,22,5,301,2854,2
5,148,96,52,5,120,92,28,5,301,2854,2
6,152,92,60,5,115,79,36,5,301,2854,2
7,151,95,56,5,116,82,34,5,301,2854,2
8,145,93,52,5,109,80,29,5,301,2854,2
9,148,96,52,5,142,107,35,5,301,2854,2
10,147,96,51,5,93,67,26,5,301,2854,2
1,167,124,43,5,154,128,26,5,167,2164,2
2,163,124,39,5,171,134,37,5,167,2164,2
3,154,127,27,5,157,129,28,5,167,2164,2
4,166,129,37,5,142,110,32,5,167,2164,2
5,165,128,37,5,132,108,24,5,167,2164,2
6,165,126,39,5,148,122,26,5,167,2164,2
7,167,122,45,5,142,117,25,5,167,2164,2
8,170,121,49,5,174,145,29,5,167,2164,2
9,170,118,52,5,153,125,28,5,167,2164,2
10,171,125,46,5,183,150,33,5,167,2164,2
1,176,129,47,5,141,118,23,5,152,2371,2
2,169,125,44,5,150,122,28,5,152,2371,2
3,164,128,36,5,171,140,31,5,152,2371,2
4,173,131,42,5,171,142,29,5,152,2371,2
5,166,131,35,5,139,110,29,5,152,2371,2
6,164,131,33,5,147,119,28,5,152,2371,2
7,165,126,39,5,178,145,33,5,152,2371,2
8,172,124,48,5,161,131,30,5,152,2371,2
9,171,120,51,5,145,118,27,5,152,2371,2
10,172,128,44,5,173,143,30,5,152,2371,2
1,165,126,39,5,177,139,38,5,287,2420,2
2,168,131,37,5,118,96,22,5,287,2420,2
3,172,126,46,5,156,127,29,5,287,2420,2
4,168,124,44,5,130,104,26,5,287,2420,2
5,168,120,48,5,144,115,29,5,287,2420,2
6,170,120,50,5,179,149,30,5,287,2420,2
7,169,120,49,5,153,130,23,5,287,2420,2
8,167,125,42,5,186,154,32,5,287,2420,2
9,164,123,41,5,170,138,32,5,287,2420,2
10,171,124,47,5,143,116,27,5,287,2420,2
1,196,161,35,5,207,190,17,5,105,2438,2
2,196,164,32,5,215,194,21,5,105,2438,2
3,194,160,34,5,208,192,16,5,105,2438,2
4,197,165,32,5,211,191,20,5,105,2438,2
5,195,164,31,5,209,189,20,5,105,2438,2
6,197,161,36,5,210,190,20,5,105,2438,2
7,196,164,32,5,207,188,19,5,105,2438,2
8,195,162,33,5,212,189,23,5,105,2438,2
9,194,158,36,5,207,187,20,5,105,2438,2
10,194,164,30,5,204,190,14,5,105,2438,2
1,116,58,58,5,85,57,28,5,499,875,2
2,121,61,60,5,90,56,34,5,499,875,2
3,114,60,54,5,87,54,33,5,499,875,2
4,118,60,58,5,99,66,33,5,499,875,2
5,117,59,58,5,87,56,31,5,499,875,2
6,122,63,59,5,75,53,22,5,499,875,2
7,123,61,62,5,104,67,37,5,499,875,2
8,121,62,59,5,105,67,38,5,499,875,2
9,118,64,54,5,97,67,30,5,499,875,2
10,125,63,62,5,75,53,22,5,499,875,2
1,196,161,35,5,207,190,17,5,143,430,2
2,196,164,32,5,215,194,21,5,143,430,2
3,194,160,34,5,208,192,16,5,143,430,2
4,197,165,32,5,211,191,20,5,143,430,2
5,195,164,31,5,209,189,20,5,143,430,2
6,197,161,36,5,210,190,20,5,143,430,2
7,196,164,32,5,207,188,19,5,143,430,2
8,195,162,33,5,212,189,23,5,143,430,2
9,194,158,36,5,207,187,20,5,143,430,2
10,194,164,30,5,204,190,14,5,143,430,2
1,166,130,36,5,177,144,33,5,176,334,2
2,167,126,41,5,147,126,21,5,176,334,2
3,165,131,34,5,152,126,26,5,176,334,2
4,172,131,41,5,137,107,30,5,176,334,2
5,168,130,38,5,157,127,30,5,176,334,2
6,176,128,48,5,157,128,29,5,176,334,2
7,169,126,43,5,175,143,32,5,176,334,2
8,173,123,50,5,166,136,30,5,176,334,2
9,166,123,43,5,166,136,30,5,176,334,2
10,166,125,41,5,140,113,27,5,176,334,2
1,175,133,42,5,174,143,31,5,260,2598,2
2,175,128,47,5,171,137,34,5,260,2598,2
3,174,132,42,5,141,117,24,5,260,2598,2
4,174,130,44,5,156,127,29,5,260,2598,2
5,171,132,39,5,140,111,29,5,260,2598,2
6,173,126,47,5,153,122,31,5,260,2598,2
7,173,130,43,5,155,130,25,5,260,2598,2
8,173,132,41,5,179,147,32,5,260,2598,2
9,172,130,42,5,178,146,32,5,260,2598,2
10,170,129,41,5,121,100,21,5,260,2598,2
1,119,61,58,5,88,60,28,5,468,1465,2
2,121,58,63,5,84,57,27,5,468,1465,2
3,115,60,55,5,97,62,35,5,468,1465,2
4,125,58,67,5,88,57,31,5,468,1465,2
5,119,56,63,5,82,52,30,5,468,1465,2
6,130,60,70,5,87,58,29,5,468,1465,2
7,114,57,57,5,96,61,35,5,468,1465,2
8,111,61,50,5,95,61,34,5,468,1465,2
9,114,59,55,5,100,65,35,5,468,1465,2
10,117,59,58,5,91,61,30,5,468,1465,2
1,196,161,35,5,207,190,17,5,103,1178,2
2,196,164,32,5,215,194,21,5,103,1178,2
3,194,160,34,5,208,192,16,5,103,1178,2
4,197,165,32,5,211,191,20,5,103,1178,2
5,195,164,31,5,209,189,20,5,103,1178,2
6,197,161,36,5,210,190,20,5,103,1178,2
7,196,164,32,5,207,188,19,5,103,1178,2
8,195,162,33,5,212,189,23,5,103,1178,2
9,194,158,36,5,207,187,20,5,103,1178,2
10,194,164,30,5,204,190,14,5,103,1178,2
1,196,161,35,5,207,190,17,5,78,2660,2
2,196,164,32,5,215,194,21,5,78,2660,2
3,194,160,34,5,208,192,16,5,78,2660,2
4,197,165,32,5,211,191,20,5,78,2660,2
5,195,164,31,5,209,189,20,5,78,2660,2
6,197,161,36,5,210,190,20,5,78,2660,2
7,196,164,32,5,207,188,19,5,78,2660,2
8,195,162,33,5,212,189,23,5,78,2660,2
9,194,158,36,5,207,187,20,5,78,2660,2
10,194,164,30,5,204,190,14,5,78,2660,2
1,196,161,35,5,207,190,17,5,15,3311,2
2,196,164,32,5,215,194,21,5,15,3311,2
3,194,160,34,5,208,192,16,5,15,3311,2
4,197,165,32,5,211,191,20,5,15,3311,2
5,195,164,31,5,209,189,20,5,15,3311,2
6,197,161,36,5,210,190,20,5,15,3311,2
7,196,164,32,5,207,188,19,5,15,3311,2
8,195,162,33,5,212,189,23,5,15,3311,2
9,194,158,36,5,207,187,20,5,15,3311,2
10,194,164,30,5,204,190,14,5,15,3311,2
1,165,123,42,5,171,144,27,5,170,2749,2
2,164,123,41,5,179,147,32,5,170,2749,2
3,165,126,39,5,119,96,23,5,170,2749,2
4,166,121,45,5,123,105,18,5,170,2749,2
5,165,122,43,5,149,120,29,5,170,2749,2
6,169,124,45,5,192,148,44,5,170,2749,2
7,162,123,39,5,143,115,28,5,170,2749,2
8,163,121,42,5,173,144,29,5,170,2749,2
9,165,125,40,5,136,114,22,5,170,2749,2
10,169,126,43,5,186,150,36,5,170,2749,2
1,137,92,45,5,91,70,21,5,297,2479,2
2,141,88,53,5,98,76,22,5,297,2479,2
3,139,90,49,5,139,105,34,5,297,2479,2
4,143,90,53,5,111,82,29,5,297,2479,2
5,137,92,45,5,131,95,36,5,297,2479,2
6,150,90,60,5,120,88,32,5,297,2479,2
7,147,90,57,5,117,86,31,5,297,2479,2
8,144,89,55,5,87,63,24,5,297,2479,2
9,142,91,51,5,112,80,32,5,297,2479,2
10,141,92,49,5,135,97,38,5,297,2479,2
1,196,161,35,5,207,190,17,5,62,2794,2
2,196,164,32,5,215,194,21,5,62,2794,2
3,194,160,34,5,208,192,16,5,62,2794,2
4,197,165,32,5,211,191,20,5,62,2794,2
5,195,164,31,5,209,189,20,5,62,2794,2
6,197,161,36,5,210,190,20,5,62,2794,2
7,196,164,32,5,207,188,19,5,62,2794,2
8,195,162,33,5,212,189,23,5,62,2794,2
9,194,158,36,5,207,187,20,5,62,2794,2
10,194,164,30,5,204,190,14,5,62,2794,2
1,147,97,50,5,121,85,36,5,298,628,2
2,150,95,55,5,95,66,29,5,298,628,2
3,152,99,53,5,102,75,27,5,298,628,2
4,150,98,52,5,101,75,26,5,298,628,2
5,145,100,45,5,127,93,34,5,298,628,2
6,153,96,57,5,106,74,32,5,298,628,2
7,147,98,49,5,117,87,30,5,298,628,2
8,148,96,52,5,109,82,27,5,298,628,2
9,147,97,50,5,100,77,23,5,298,628,2
10,153,97,56,5,125,92,33,5,298,628,2
1,196,161,35,5,212,191,21,5,101,1222,2
2,196,162,34,5,215,188,27,5,101,1222,2
3,193,162,31,5,211,190,21,5,101,1222,2
4,195,162,33,5,214,192,22,5,101,1222,2
5,196,166,30,5,216,190,26,5,101,1222,2
6,203,166,37,5,210,187,23,5,101,1222,2
7,196,162,34,5,210,191,19,5,101,1222,2
8,197,168,29,5,211,190,21,5,101,1222,2
9,196,165,31,5,210,189,21,5,101,1222,2
10,194,163,31,5,209,188,21,5,101,1222,2
1,164,131,33,5,156,124,32,5,232,2824,2
2,171,132,39,5,139,111,28,5,232,2824,2
3,175,127,48,5,175,143,32,5,232,2824,2
4,175,127,48,5,159,132,27,5,232,2824,2
5,174,128,46,5,158,128,30,5,232,2824,2
6,171,125,46,5,140,120,20,5,232,2824,2
7,169,127,42,5,142,113,29,5,232,2824,2
8,168,124,44,5,173,145,28,5,232,2824,2
9,169,123,46,5,160,129,31,5,232,2824,2
10,173,131,42,5,176,145,31,5,232,2824,2
1,165,126,39,5,177,139,38,5,276,827,2
2,168,131,37,5,118,96,22,5,276,827,2
3,172,126,46,5,156,127,29,5,276,827,2
4,168,124,44,5,130,104,26,5,276,827,2
5,168,120,48,5,144,115,29,5,276,827,2
6,170,120,50,5,179,149,30,5,276,827,2
7,169,120,49,5,153,130,23,5,276,827,2
8,167,125,42,5,186,154,32,5,276,827,2
9,164,123,41,5,170,138,32,5,276,827,2
10,171,124,47,5,143,116,27,5,276,827,2
1,196,161,35,5,207,190,17,5,22,3555,2
2,196,164,32,5,215,194,21,5,22,3555,2
3,194,160,34,5,208,192,16,5,22,3555,2
4,197,165,32,5,211,191,20,5,22,3555,2
5,195,164,31,5,209,189,20,5,22,3555,2
6,197,161,36,5,210,190,20,5,22,3555,2
7,196,164,32,5,207,188,19,5,22,3555,2
8,195,162,33,5,212,189,23,5,22,3555,2
9,194,158,36,5,207,187,20,5,22,3555,2
10,194,164,30,5,204,190,14,5,22,3555,2
1,170,134,36,5,174,142,32,5,147,2257,2
2,171,131,40,5,177,147,30,5,147,2257,2
3,171,134,37,5,188,152,36,5,147,2257,2
4,175,132,43,5,162,134,28,5,147,2257,2
5,173,134,39,5,134,111,23,5,147,2257,2
6,167,129,38,5,159,128,31,5,147,2257,2
7,172,133,39,5,144,114,30,5,147,2257,2
8,171,127,44,5,129,109,20,5,147,2257,2
9,175,133,42,5,159,128,31,5,147,2257,2
10,171,131,40,5,146,119,27,5,147,2257,2
1,196,161,35,5,207,190,17,5,134,3039,2
2,196,164,32,5,215,194,21,5,134,3039,2
3,194,160,34,5,208,192,16,5,134,3039,2
4,197,165,32,5,211,191,20,5,134,3039,2
5,195,164,31,5,209,189,20,5,134,3039,2
6,197,161,36,5,210,190,20,5,134,3039,2
7,196,164,32,5,207,188,19,5,134,3039,2
8,195,162,33,5,212,189,23,5,134,3039,2
9,194,158,36,5,207,187,20,5,134,3039,2
10,194,164,30,5,204,190,14,5,134,3039,2
1,122,61,61,5,90,60,30,5,455,208,2
2,123,66,57,5,79,53,26,5,455,208,2
3,122,58,64,5,91,57,34,5,455,208,2
4,127,63,64,5,111,67,44,5,455,208,2
5,115,57,58,5,79,54,25,5,455,208,2
6,124,61,63,5,86,56,30,5,455,208,2
7,116,62,54,5,82,53,29,5,455,208,2
8,114,65,49,5,108,68,40,5,455,208,2
9,119,62,57,5,106,68,38,5,455,208,2
10,117,60,57,5,86,57,29,5,455,208,2
1,145,90,55,5,102,76,26,5,335,2706,2
2,140,87,53,5,88,64,24,5,335,2706,2
3,134,89,45,5,109,80,29,5,335,2706,2
4,140,85,55,5,123,85,38,5,335,2706,2
5,144,87,57,5,138,103,35,5,335,2706,2
6,135,86,49,5,108,81,27,5,335,2706,2
7,136,83,53,5,119,87,32,5,335,2706,2
8,141,85,56,5,121,91,30,5,335,2706,2
9,138,87,51,5,117,86,31,5,335,2706,2
10,145,87,58,5,113,86,27,5,335,2706,2
1,165,124,41,5,158,132,26,5,150,2164,2
2,165,125,40,5,139,110,29,5,150,2164,2
3,163,126,37,5,177,144,33,5,150,2164,2
4,168,126,42,5,154,123,31,5,150,2164,2
5,164,127,37,5,161,130,31,5,150,2164,2
6,171,122,49,5,179,146,33,5,150,2164,2
7,165,118,47,5,140,116,24,5,150,2164,2
8,168,130,38,5,165,133,32,5,150,2164,2
9,165,125,40,5,168,137,31,5,150,2164,2
10,170,128,42,5,134,116,18,5,150,2164,2
1,169,132,37,5,158,126,32,5,208,2874,2
2,178,130,48,5,138,112,26,5,208,2874,2
3,172,131,41,5,132,107,25,5,208,2874,2
4,169,124,45,5,162,133,29,5,208,2874,2
5,164,128,36,5,161,130,31,5,208,2874,2
6,165,126,39,5,188,152,36,5,208,2874,2
7,168,127,41,5,173,145,28,5,208,2874,2
8,171,126,45,5,169,138,31,5,208,2874,2
9,168,126,42,5,124,103,21,5,208,2874,2
10,170,120,50,5,164,135,29,5,208,2874,2
1,169,127,42,5,132,113,19,5,231,799,2
2,165,132,33,5,160,135,25,5,231,799,2
3,169,123,46,5,171,138,33,5,231,799,2
4,168,126,42,5,141,116,25,5,231,799,2
5,172,125,47,5,173,141,32,5,231,799,2
6,175,126,49,5,174,142,32,5,231,799,2
7,172,127,45,5,186,147,39,5,231,799,2
8,167,127,40,5,146,117,29,5,231,799,2
9,170,125,45,5,139,114,25,5,231,799,2
10,168,128,40,5,158,129,29,5,231,799,2
1,196,161,35,5,207,190,17,5,127,428,2
2,196,164,32,5,215,194,21,5,127,428,2
3,194,160,34,5,208,192,16,5,127,428,2
4,197,165,32,5,211,191,20,5,127,428,2
5,195,164,31,5,209,189,20,5,127,428,2
6,197,161,36,5,210,190,20,5,127,428,2
7,196,164,32,5,207,188,19,5,127,428,2
8,195,162,33,5,212,189,23,5,127,428,2
9,194,158,36,5,207,187,20,5,127,428,2
10,194,164,30,5,204,190,14,5,127,428,2
1,165,126,39,5,177,139,38,5,287,1581,2
2,168,131,37,5,118,96,22,5,287,1581,2
3,172,126,46,5,156,127,29,5,287,1581,2
4,168,124,44,5,130,104,26,5,287,1581,2
5,168,120,48,5,144,115,29,5,287,1581,2
6,170,120,50,5,179,149,30,5,287,1581,2
7,169,120,49,5,153,130,23,5,287,1581,2
8,167,125,42,5,186,154,32,5,287,1581,2
9,164,123,41,5,170,138,32,5,287,1581,2
10,171,124,47,5,143,116,27,5,287,1581,2
1,196,161,35,5,207,190,17,5,40,1748,2
2,196,164,32,5,215,194,21,5,40,1748,2
3,194,160,34,5,208,192,16,5,40,1748,2
4,197,165,32,5,211,191,20,5,40,1748,2
5,195,164,31,5,209,189,20,5,40,1748,2
6,197,161,36,5,210,190,20,5,40,1748,2
7,196,164,32,5,207,188,19,5,40,1748,2
8,195,162,33,5,212,189,23,5,40,1748,2
9,194,158,36,5,207,187,20,5,40,1748,2
10,194,164,30,5,204,190,14,5,40,1748,2
1,128,84,44,5,114,84,30,5,320,1926,2
2,126,86,40,5,94,73,21,5,320,1926,2
3,134,87,47,5,111,79,32,5,320,1926,2
4,147,86,61,5,128,91,37,5,320,1926,2
5,145,89,56,5,87,64,23,5,320,1926,2
6,148,87,61,5,124,88,36,5,320,1926,2
7,145,87,58,5,114,82,32,5,320,1926,2
8,143,83,60,5,129,96,33,5,320,1926,2
9,133,82,51,5,108,82,26,5,320,1926,2
10,141,82,59,5,107,80,27,5,320,1926,2
1,196,161,35,5,207,190,17,5,119,1309,2
2,196,164,32,5,215,194,21,5,119,1309,2
3,194,160,34,5,208,192,16,5,119,1309,2
4,197,165,32,5,211,191,20,5,119,1309,2
5,195,164,31,5,209,189,20,5,119,1309,2
6,197,161,36,5,210,190,20,5,119,1309,2
7,196,164,32,5,207,188,19,5,119,1309,2
8,195,162,33,5,212,189,23,5,119,1309,2
9,194,158,36,5,207,187,20,5,119,1309,2
10,194,164,30,5,204,190,14,5,119,1309,2
1,169,129,40,5,156,131,25,5,205,2343,2
2,173,135,38,5,137,110,27,5,205,2343,2
3,174,129,45,5,163,133,30,5,205,2343,2
4,171,122,49,5,153,125,28,5,205,2343,2
5,162,126,36,5,142,115,27,5,205,2343,2
6,171,126,45,5,152,124,28,5,205,2343,2
7,171,133,38,5,129,103,26,5,205,2343,2
8,166,130,36,5,173,141,32,5,205,2343,2
9,173,128,45,5,173,145,28,5,205,2343,2
10,176,127,49,5,186,149,37,5,205,2343,2
1,196,161,35,5,207,190,17,5,53,2192,2
2,196,164,32,5,215,194,21,5,53,2192,2
3,194,160,34,5,208,192,16,5,53,2192,2
4,197,165,32,5,211,191,20,5,53,2192,2
5,195,164,31,5,209,189,20,5,53,2192,2
6,197,161,36,5,210,190,20,5,53,2192,2
7,196,164,32,5,207,188,19,5,53,2192,2
8,195,162,33,5,212,189,23,5,53,2192,2
9,194,158,36,5,207,187,20,5,53,2192,2
10,194,164,30,5,204,190,14,5,53,2192,2
1,112,62,50,5,99,65,34,5,452,1540,2
2,120,58,62,5,90,63,27,5,452,1540,2
3,109,60,49,5,76,51,25,5,452,1540,2
4,121,59,62,5,101,63,38,5,452,1540,2
5,120,60,60,5,99,58,41,5,452,1540,2
6,136,58,78,5,80,53,27,5,452,1540,2
7,123,60,63,5,89,58,31,5,452,1540,2
8,113,59,54,5,96,62,34,5,452,1540,2
9,113,61,52,5,102,66,36,5,452,1540,2
10,120,59,61,5,71,54,17,5,452,1540,2
1,163,126,37,5,186,157,29,5,159,1453,2
2,165,124,41,5,189,152,37,5,159,1453,2
3,166,123,43,5,144,115,29,5,159,1453,2
4,174,126,48,5,134,111,23,5,159,1453,2
5,168,126,42,5,135,110,25,5,159,1453,2
6,167,124,43,5,134,108,26,5,159,1453,2
7,171,127,44,5,151,127,24,5,159,1453,2
8,158,123,35,5,169,137,32,5,159,1453,2
9,166,123,43,5,185,147,38,5,159,1453,2
10,167,123,44,5,139,113,26,5,159,1453,2
1,196,161,35,5,207,190,17,5,38,2820,2
2,196,164,32,5,215,194,21,5,38,2820,2
3,194,160,34,5,208,192,16,5,38,2820,2
4,197,165,32,5,211,191,20,5,38,2820,2
5,195,164,31,5,209,189,20,5,38,2820,2
6,197,161,36,5,210,190,20,5,38,2820,2
7,196,164,32,5,207,188,19,5,38,2820,2
8,195,162,33,5,212,189,23,5,38,2820,2
9,194,158,36,5,207,187,20,5,38,2820,2
10,194,164,30,5,204,190,14,5,38,2820,2
1,141,86,55,5,92,67,25,5,416,1779,2
2,142,81,61,5,109,79,30,5,416,1779,2
3,137,82,55,5,72,58,14,5,416,1779,2
4,129,79,50,5,114,80,34,5,416,1779,2
5,133,79,54,5,101,75,26,5,416,1779,2
6,134,81,53,5,117,85,32,5,416,1779,2
7,124,81,43,5,107,78,29,5,416,1779,2
8,132,81,51,5,100,72,28,5,416,1779,2
9,141,80,61,5,145,104,41,5,416,1779,2
10,135,82,53,5,116,82,34,5,416,1779,2
1,196,161,35,5,207,190,17,5,108,1243,2
2,196,164,32,5,215,194,21,5,108,1243,2
3,194,160,34,5,208,192,16,5,108,1243,2
4,197,165,32,5,211,191,20,5,108,1243,2
5,195,164,31,5,209,189,20,5,108,1243,2
6,197,161,36,5,210,190,20,5,108,1243,2
7,196,164,32,5,207,188,19,5,108,1243,2
8,195,162,33,5,212,189,23,5,108,1243,2
9,194,158,36,5,207,187,20,5,108,1243,2
10,194,164,30,5,204,190,14,5,108,1243,2
1,128,79,49,5,115,83,32,5,390,1202,2
2,138,82,56,5,115,78,37,5,390,1202,2
3,139,80,59,5,101,72,29,5,390,1202,2
4,132,79,53,5,107,79,28,5,390,1202,2
5,139,81,58,5,97,76,21,5,390,1202,2
6,138,81,57,5,103,78,25,5,390,1202,2
7,134,83,51,5,125,93,32,5,390,1202,2
8,135,82,53,5,103,77,26,5,390,1202,2
9,134,80,54,5,136,101,35,5,390,1202,2
10,137,81,56,5,120,88,32,5,390,1202,2
1,165,122,43,5,182,146,36,5,169,816,2
2,168,129,39,5,156,130,26,5,169,816,2
3,163,128,35,5,162,134,28,5,169,816,2
4,169,124,45,5,138,109,29,5,169,816,2
5,164,126,38,5,123,101,22,5,169,816,2
6,167,125,42,5,151,119,32,5,169,816,2
7,165,122,43,5,151,124,27,5,169,816,2
8,165,122,43,5,161,128,33,5,169,816,2
9,168,125,43,5,175,146,29,5,169,816,2
10,167,123,44,5,170,144,26,5,169,816,2
1,180,135,45,5,138,113,25,5,195,2711,2
2,180,136,44,5,147,119,28,5,195,2711,2
3,175,137,38,5,141,120,21,5,195,2711,2
4,176,131,45,5,180,144,36,5,195,2711,2
5,174,130,44,5,182,148,34,5,195,2711,2
6,173,135,38,5,155,127,28,5,195,2711,2
7,172,132,40,5,152,126,26,5,195,2711,2
8,174,132,42,5,163,136,27,5,195,2711,2
9,176,136,40,5,151,118,33,5,195,2711,2
10,177,135,42,5,153,123,30,5,195,2711,2
1,196,161,35,5,212,191,21,5,100,1940,2
2,196,162,34,5,215,188,27,5,100,1940,2
3,193,162,31,5,211,190,21,5,100,1940,2
4,195,162,33,5,214,192,22,5,100,1940,2
5,196,166,30,5,216,190,26,5,100,1940,2
6,203,166,37,5,210,187,23,5,100,1940,2
7,196,162,34,5,210,191,19,5,100,1940,2
8,197,168,29,5,211,190,21,5,100,1940,2
9,196,165,31,5,210,189,21,5,100,1940,2
10,194,163,31,5,209,188,21,5,100,1940,2
1,118,65,53,5,93,64,29,5,451,3515,2
2,130,65,65,5,82,53,29,5,451,3515,2
3,106,65,41,5,90,59,31,5,451,3515,2
4,118,64,54,5,90,57,33,5,451,3515,2
5,125,67,58,5,88,58,30,5,451,3515,2
6,139,65,74,5,90,60,30,5,451,3515,2
7,119,63,56,5,97,63,34,5,451,3515,2
8,122,66,56,5,92,58,34,5,451,3515,2
9,127,61,66,5,98,64,34,5,451,3515,2
10,126,63,63,5,86,58,28,5,451,3515,2
1,159,123,36,5,178,148,30,5,214,195,2
2,162,122,40,5,148,124,24,5,214,195,2
3,162,120,42,5,181,150,31,5,214,195,2
4,164,121,43,5,132,109,23,5,214,195,2
5,174,123,51,5,158,127,31,5,214,195,2
6,169,122,47,5,169,137,32,5,214,195,2
7,164,126,38,5,117,95,22,5,214,195,2
8,160,118,42,5,181,142,39,5,214,195,2
9,162,118,44,5,127,104,23,5,214,195,2
10,158,125,33,5,178,145,33,5,214,195,2
1,174,129,45,5,151,129,22,5,173,2760,2
2,170,133,37,5,178,145,33,5,173,2760,2
3,175,133,42,5,166,137,29,5,173,2760,2
4,177,129,48,5,141,115,26,5,173,2760,2
5,174,129,45,5,168,137,31,5,173,2760,2
6,172,128,44,5,144,118,26,5,173,2760,2
7,175,128,47,5,137,109,28,5,173,2760,2
8,165,128,37,5,151,123,28,5,173,2760,2
9,160,129,31,5,178,139,39,5,173,2760,2
10,172,128,44,5,156,130,26,5,173,2760,2
1,196,161,35,5,207,190,17,5,78,2206,2
2,196,164,32,5,215,194,21,5,78,2206,2
3,194,160,34,5,208,192,16,5,78,2206,2
4,197,165,32,5,211,191,20,5,78,2206,2
5,195,164,31,5,209,189,20,5,78,2206,2
6,197,161,36,5,210,190,20,5,78,2206,2
7,196,164,32,5,207,188,19,5,78,2206,2
8,195,162,33,5,212,189,23,5,78,2206,2
9,194,158,36,5,207,187,20,5,78,2206,2
10,194,164,30,5,204,190,14,5,78,2206,2
1,191,153,38,5,126,100,26,5,179,3566,2
2,192,149,43,5,122,100,22,5,179,3566,2
3,187,151,36,5,182,149,33,5,179,3566,2
4,185,148,37,5,149,123,26,5,179,3566,2
5,187,151,36,5,175,136,39,5,179,3566,2
6,185,152,33,5,182,150,32,5,179,3566,2
7,184,153,31,5,185,152,33,5,179,3566,2
8,192,155,37,5,173,144,29,5,179,3566,2
9,197,149,48,5,142,117,25,5,179,3566,2
10,192,149,43,5,137,114,23,5,179,3566,2
1,177,127,50,5,169,133,36,5,243,2535,2
2,177,129,48,5,165,127,38,5,243,2535,2
3,183,126,57,5,170,133,37,5,243,2535,2
4,180,126,54,5,168,134,34,5,243,2535,2
5,179,127,52,5,164,131,33,5,243,2535,2
6,182,127,55,5,166,134,32,5,243,2535,2
7,178,126,52,5,166,131,35,5,243,2535,2
8,183,128,55,5,169,134,35,5,243,2535,2
9,179,127,52,5,170,128,42,5,243,2535,2
10,182,127,55,5,167,129,38,5,243,2535,2
1,130,69,61,5,107,77,30,5,387,1836,2
2,127,70,57,5,102,73,29,5,387,1836,2
3,125,71,54,5,119,89,30,5,387,1836,2
4,126,70,56,5,96,74,22,5,387,1836,2
5,130,71,59,5,110,78,32,5,387,1836,2
6,129,73,56,5,91,67,24,5,387,1836,2
7,122,70,52,5,123,87,36,5,387,1836,2
8,119,68,51,5,95,71,24,5,387,1836,2
9,122,70,52,5,114,80,34,5,387,1836,2
10,127,68,59,5,119,84,35,5,387,1836,2
1,133,67,66,5,76,51,25,5,446,2295,2
2,132,70,62,5,94,59,35,5,446,2295,2
3,126,66,60,5,96,60,36,5,446,2295,2
4,118,62,56,5,72,50,22,5,446,2295,2
5,118,65,53,5,88,59,29,5,446,2295,2
6,113,68,45,5,97,60,37,5,446,2295,2
7,116,68,48,5,103,68,35,5,446,2295,2
8,127,69,58,5,85,57,28,5,446,2295,2
9,136,62,74,5,98,67,31,5,446,2295,2
10,125,68,57,5,86,57,29,5,446,2295,2
1,196,161,35,5,207,190,17,5,145,1032,2
2,196,164,32,5,215,194,21,5,145,1032,2
3,194,160,34,5,208,192,16,5,145,1032,2
4,197,165,32,5,211,191,20,5,145,1032,2
5,195,164,31,5,209,189,20,5,145,1032,2
6,197,161,36,5,210,190,20,5,145,1032,2
7,196,164,32,5,207,188,19,5,145,1032,2
8,195,162,33,5,212,189,23,5,145,1032,2
9,194,158,36,5,207,187,20,5,145,1032,2
10,194,164,30,5,204,190,14,5,145,1032,2
1,163,96,67,5,141,95,46,5,338,1710,2
2,156,100,56,5,129,96,33,5,338,1710,2
3,159,106,53,5,164,118,46,5,338,1710,2
4,167,105,62,5,136,96,40,5,338,1710,2
5,161,105,56,5,163,112,51,5,338,1710,2
6,173,101,72,5,133,93,40,5,338,1710,2
7,166,103,63,5,154,110,44,5,338,1710,2
8,168,104,64,5,158,112,46,5,338,1710,2
9,164,101,63,5,111,76,35,5,338,1710,2
10,174,96,78,5,159,108,51,5,338,1710,2
1,167,117,50,5,135,111,24,5,153,1986,2
2,161,116,45,5,158,130,28,5,153,1986,2
3,160,119,41,5,157,129,28,5,153,1986,2
4,169,122,47,5,179,148,31,5,153,1986,2
5,159,123,36,5,160,127,33,5,153,1986,2
6,160,119,41,5,148,121,27,5,153,1986,2
7,163,119,44,5,182,144,38,5,153,1986,2
8,162,119,43,5,159,127,32,5,153,1986,2
9,165,121,44,5,129,110,19,5,153,1986,2
10,161,123,38,5,165,137,28,5,153,1986,2
1,196,161,35,5,207,190,17,5,45,3654,2
2,196,164,32,5,215,194,21,5,45,3654,2
3,194,160,34,5,208,192,16,5,45,3654,2
4,197,165,32,5,211,191,20,5,45,3654,2
5,195,164,31,5,209,189,20,5,45,3654,2
6,197,161,36,5,210,190,20,5,45,3654,2
7,196,164,32,5,207,188,19,5,45,3654,2
8,195,162,33,5,212,189,23,5,45,3654,2
9,194,158,36,5,207,187,20,5,45,3654,2
10,194,164,30,5,204,190,14,5,45,3654,2
1,184,133,51,5,199,158,41,5,240,3721,2
2,186,132,54,5,202,156,46,5,240,3721,2
3,187,135,52,5,207,158,49,5,240,3721,2
4,184,125,59,5,203,155,48,5,240,3721,2
5,183,128,55,5,192,155,37,5,240,3721,2
6,187,129,58,5,203,158,45,5,240,3721,2
7,184,129,55,5,203,155,48,5,240,3721,2
8,184,128,56,5,198,154,44,5,240,3721,2
9,182,128,54,5,203,153,50,5,240,3721,2
10,186,129,57,5,201,156,45,5,240,3721,2
1,138,79,59,5,93,70,23,5,367,431,2
2,134,81,53,5,97,69,28,5,367,431,2
3,136,80,56,5,107,77,30,5,367,431,2
4,129,81,48,5,110,78,32,5,367,431,2
5,134,81,53,5,144,108,36,5,367,431,2
6,140,81,59,5,105,80,25,5,367,431,2
7,139,81,58,5,112,79,33,5,367,431,2
8,142,83,59,5,98,73,25,5,367,431,2
9,132,79,53,5,111,80,31,5,367,431,2
10,129,81,48,5,122,89,33,5,367,431,2
1,115,59,56,5,103,65,38,5,437,458,2
2,118,62,56,5,92,60,32,5,437,458,2
3,122,62,60,5,82,54,28,5,437,458,2
4,115,64,51,5,92,63,29,5,437,458,2
5,113,64,49,5,92,58,34,5,437,458,2
6,125,64,61,5,93,57,36,5,437,458,2
7,122,63,59,5,86,60,26,5,437,458,2
8,122,62,60,5,90,60,30,5,437,458,2
9,119,59,60,5,95,63,32,5,437,458,2
10,131,60,71,5,83,56,27,5,437,458,2
1,196,161,35,5,207,190,17,5,67,1567,2
2,196,164,32,5,215,194,21,5,67,1567,2
3,194,160,34,5,208,192,16,5,67,1567,2
4,197,165,32,5,211,191,20,5,67,1567,2
5,195,164,31,5,209,189,20,5,67,1567,2
6,197,161,36,5,210,190,20,5,67,1567,2
7,196,164,32,5,207,188,19,5,67,1567,2
8,195,162,33,5,212,189,23,5,67,1567,2
9,194,158,36,5,207,187,20,5,67,1567,2
10,194,164,30,5,204,190,14,5,67,1567,2
1,126,71,55,5,98,74,24,5,424,73,2
2,127,74,53,5,84,58,26,5,424,73,2
3,129,74,55,5,98,70,28,5,424,73,2
4,132,74,58,5,105,74,31,5,424,73,2
5,136,73,63,5,113,87,26,5,424,73,2
6,132,75,57,5,111,84,27,5,424,73,2
7,130,78,52,5,135,98,37,5,424,73,2
8,121,73,48,5,107,80,27,5,424,73,2
9,127,76,51,5,124,85,39,5,424,73,2
10,136,73,63,5,109,80,29,5,424,73,2
1,154,95,59,5,108,75,33,5,309,2685,2
2,151,95,56,5,106,72,34,5,309,2685,2
3,142,97,45,5,119,85,34,5,309,2685,2
4,151,95,56,5,115,86,29,5,309,2685,2
5,148,99,49,5,104,76,28,5,309,2685,2
6,147,98,49,5,127,93,34,5,309,2685,2
7,147,98,49,5,109,80,29,5,309,2685,2
8,147,97,50,5,120,91,29,5,309,2685,2
9,151,98,53,5,115,86,29,5,309,2685,2
10,149,95,54,5,91,71,20,5,309,2685,2
1,128,79,49,5,115,83,32,5,390,1948,2
2,138,82,56,5,115,78,37,5,390,1948,2
3,139,80,59,5,101,72,29,5,390,1948,2
4,132,79,53,5,107,79,28,5,390,1948,2
5,139,81,58,5,97,76,21,5,390,1948,2
6,138,81,57,5,103,78,25,5,390,1948,2
7,134,83,51,5,125,93,32,5,390,1948,2
8,135,82,53,5,103,77,26,5,390,1948,2
9,134,80,54,5,136,101,35,5,390,1948,2
10,137,81,56,5,120,88,32,5,390,1948,2
1,134,79,55,5,103,77,26,5,332,3554,2
2,142,82,60,5,118,85,33,5,332,3554,2
3,137,78,59,5,101,80,21,5,332,3554,2
4,132,78,54,5,163,115,48,5,332,3554,2
5,133,81,52,5,117,86,31,5,332,3554,2
6,129,80,49,5,105,76,29,5,332,3554,2
7,131,78,53,5,103,80,23,5,332,3554,2
8,124,79,45,5,91,66,25,5,332,3554,2
9,135,77,58,5,111,79,32,5,332,3554,2
10,132,80,52,5,130,95,35,5,332,3554,2
1,170,134,36,5,174,142,32,5,147,3758,2
2,171,131,40,5,177,147,30,5,147,3758,2
3,171,134,37,5,188,152,36,5,147,3758,2
4,175,132,43,5,162,134,28,5,147,3758,2
5,173,134,39,5,134,111,23,5,147,3758,2
6,167,129,38,5,159,128,31,5,147,3758,2
7,172,133,39,5,144,114,30,5,147,3758,2
8,171,127,44,5,129,109,20,5,147,3758,2
9,175,133,42,5,159,128,31,5,147,3758,2
10,171,131,40,5,146,119,27,5,147,3758,2
1,167,133,34,5,179,143,36,5,237,1299,2
2,173,131,42,5,140,114,26,5,237,1299,2
3,172,126,46,5,171,141,30,5,237,1299,2
4,174,126,48,5,142,117,25,5,237,1299,2
5,170,130,40,5,144,116,28,5,237,1299,2
6,176,127,49,5,166,137,29,5,237,1299,2
7,171,126,45,5,174,145,29,5,237,1299,2
8,171,124,47,5,155,128,27,5,237,1299,2
9,166,124,42,5,171,137,34,5,237,1299,2
10,170,128,42,5,133,109,24,5,237,1299,2
1,196,161,35,5,212,191,21,5,102,1102,2
2,196,162,34,5,215,188,27,5,102,1102,2
3,193,162,31,5,211,190,21,5,102,1102,2
4,195,162,33,5,214,192,22,5,102,1102,2
5,196,166,30,5,216,190,26,5,102,1102,2
6,203,166,37,5,210,187,23,5,102,1102,2
7,196,162,34,5,210,191,19,5,102,1102,2
8,197,168,29,5,211,190,21,5,102,1102,2
9,196,165,31,5,210,189,21,5,102,1102,2
10,194,163,31,5,209,188,21,5,102,1102,2
1,196,161,35,5,207,190,17,5,122,1489,2
2,196,164,32,5,215,194,21,5,122,1489,2
3,194,160,34,5,208,192,16,5,122,1489,2
4,197,165,32,5,211,191,20,5,122,1489,2
5,195,164,31,5,209,189,20,5,122,1489,2
6,197,161,36,5,210,190,20,5,122,1489,2
7,196,164,32,5,207,188,19,5,122,1489,2
8,195,162,33,5,212,189,23,5,122,1489,2
9,194,158,36,5,207,187,20,5,122,1489,2
10,194,164,30,5,204,190,14,5,122,1489,2
1,132,76,56,5,122,87,35,5,417,1590,2
2,139,78,61,5,79,58,21,5,417,1590,2
3,134,74,60,5,93,65,28,5,417,1590,2
4,134,80,54,5,131,91,40,5,417,1590,2
5,134,78,56,5,98,74,24,5,417,1590,2
6,133,77,56,5,100,74,26,5,417,1590,2
7,131,77,54,5,119,88,31,5,417,1590,2
8,133,80,53,5,99,76,23,5,417,1590,2
9,129,78,51,5,116,85,31,5,417,1590,2
10,128,78,50,5,124,87,37,5,417,1590,2
1,141,90,51,5,135,100,35,5,333,614,2
2,152,89,63,5,111,81,30,5,333,614,2
3,145,90,55,5,122,86,36,5,333,614,2
4,150,90,60,5,143,106,37,5,333,614,2
5,142,89,53,5,92,75,17,5,333,614,2
6,149,89,60,5,94,71,23,5,333,614,2
7,134,89,45,5,118,88,30,5,333,614,2
8,131,89,42,5,102,76,26,5,333,614,2
9,142,89,53,5,108,80,28,5,333,614,2
10,145,90,55,5,107,76,31,5,333,614,2
1,196,161,35,5,207,190,17,5,131,2081,2
2,196,164,32,5,215,194,21,5,131,2081,2
3,194,160,34,5,208,192,16,5,131,2081,2
4,197,165,32,5,211,191,20,5,131,2081,2
5,195,164,31,5,209,189,20,5,131,2081,2
6,197,161,36,5,210,190,20,5,131,2081,2
7,196,164,32,5,207,188,19,5,131,2081,2
8,195,162,33,5,212,189,23,5,131,2081,2
9,194,158,36,5,207,187,20,5,131,2081,2
10,194,164,30,5,204,190,14,5,131,2081,2
1,121,75,46,5,81,54,27,5,449,2199,2
2,123,75,48,5,94,61,33,5,449,2199,2
3,122,76,46,5,79,57,22,5,449,2199,2
4,135,75,60,5,85,57,28,5,449,2199,2
5,133,76,57,5,100,65,35,5,449,2199,2
6,137,72,65,5,91,56,35,5,449,2199,2
7,128,75,53,5,86,56,30,5,449,2199,2
8,129,75,54,5,108,71,37,5,449,2199,2
9,133,73,60,5,92,60,32,5,449,2199,2
10,139,66,73,5,111,73,38,5,449,2199,2
1,131,76,55,5,120,90,30,5,374,2882,2
2,131,76,55,5,87,63,24,5,374,2882,2
3,135,79,56,5,118,91,27,5,374,2882,2
4,130,78,52,5,143,100,43,5,374,2882,2
5,137,77,60,5,107,82,25,5,374,2882,2
6,133,80,53,5,135,98,37,5,374,2882,2
7,135,76,59,5,110,80,30,5,374,2882,2
8,133,78,55,5,113,82,31,5,374,2882,2
9,132,77,55,5,129,96,33,5,374,2882,2
10,133,81,52,5,98,75,23,5,374,2882,2
1,127,88,39,5,125,90,35,5,317,617,2
2,146,91,55,5,131,93,38,5,317,617,2
3,136,91,45,5,120,89,31,5,317,617,2
4,140,87,53,5,94,69,25,5,317,617,2
5,146,90,56,5,124,93,31,5,317,617,2
6,148,89,59,5,104,77,27,5,317,617,2
7,151,88,63,5,132,96,36,5,317,617,2
8,140,90,50,5,103,77,26,5,317,617,2
9,141,90,51,5,94,67,27,5,317,617,2
10,146,90,56,5,127,93,34,5,317,617,2
1,195,136,59,5,157,129,28,5,269,674,2
2,188,134,54,5,164,132,32,5,269,674,2
3,193,138,55,5,164,129,35,5,269,674,2
4,191,143,48,5,168,135,33,5,269,674,2
5,192,136,56,5,172,129,43,5,269,674,2
6,192,139,53,5,162,124,38,5,269,674,2
7,187,130,57,5,171,130,41,5,269,674,2
8,186,139,47,5,174,130,44,5,269,674,2
9,189,142,47,5,165,130,35,5,269,674,2
10,184,139,45,5,164,128,36,5,269,674,2
1,131,75,56,5,89,63,26,5,363,1158,2
2,128,72,56,5,114,80,34,5,363,1158,2
3,131,73,58,5,88,66,22,5,363,1158,2
4,131,73,58,5,107,82,25,5,363,1158,2
5,127,74,53,5,128,93,35,5,363,1158,2
6,130,77,53,5,99,72,27,5,363,1158,2
7,128,78,50,5,114,84,30,5,363,1158,2
8,127,72,55,5,127,90,37,5,363,1158,2
9,129,75,54,5,123,91,32,5,363,1158,2
10,134,72,62,5,118,86,32,5,363,1158,2
1,165,126,39,5,177,139,38,5,288,1914,2
2,168,131,37,5,118,96,22,5,288,1914,2
3,172,126,46,5,156,127,29,5,288,1914,2
4,168,124,44,5,130,104,26,5,288,1914,2
5,168,120,48,5,144,115,29,5,288,1914,2
6,170,120,50,5,179,149,30,5,288,1914,2
7,169,120,49,5,153,130,23,5,288,1914,2
8,167,125,42,5,186,154,32,5,288,1914,2
9,164,123,41,5,170,138,32,5,288,1914,2
10,171,124,47,5,143,116,27,5,288,1914,2
1,130,82,48,5,90,62,28,5,427,1486,2
2,137,80,57,5,92,62,30,5,427,1486,2
3,136,81,55,5,109,75,34,5,427,1486,2
4,143,76,67,5,117,83,34,5,427,1486,2
5,145,82,63,5,93,75,18,5,427,1486,2
6,131,84,47,5,129,96,33,5,427,1486,2
7,140,85,55,5,143,109,34,5,427,1486,2
8,138,80,58,5,125,93,32,5,427,1486,2
9,131,84,47,5,121,93,28,5,427,1486,2
10,132,82,50,5,129,97,32,5,427,1486,2
1,196,161,35,5,207,190,17,5,35,1485,2
2,196,164,32,5,215,194,21,5,35,1485,2
3,194,160,34,5,208,192,16,5,35,1485,2
4,197,165,32,5,211,191,20,5,35,1485,2
5,195,164,31,5,209,189,20,5,35,1485,2
6,197,161,36,5,210,190,20,5,35,1485,2
7,196,164,32,5,207,188,19,5,35,1485,2
8,195,162,33,5,212,189,23,5,35,1485,2
9,194,158,36,5,207,187,20,5,35,1485,2
10,194,164,30,5,204,190,14,5,35,1485,2
1,130,80,50,5,105,77,28,5,401,815,2
2,135,81,54,5,103,73,30,5,401,815,2
3,138,76,62,5,82,62,20,5,401,815,2
4,134,78,56,5,110,79,31,5,401,815,2
5,137,79,58,5,107,78,29,5,401,815,2
6,132,82,50,5,101,72,29,5,401,815,2
7,138,82,56,5,106,78,28,5,401,815,2
8,140,80,60,5,108,78,30,5,401,815,2
9,126,82,44,5,120,88,32,5,401,815,2
10,133,81,52,5,144,102,42,5,401,815,2
1,192,133,59,5,163,131,32,5,261,1325,2
2,187,131,56,5,168,134,34,5,261,1325,2
3,183,132,51,5,170,127,43,5,261,1325,2
4,176,134,42,5,169,130,39,5,261,1325,2
5,187,129,58,5,166,133,33,5,261,1325,2
6,186,128,58,5,162,128,34,5,261,1325,2
7,182,133,49,5,169,133,36,5,261,1325,2
8,182,130,52,5,169,131,38,5,261,1325,2
9,181,129,52,5,164,129,35,5,261,1325,2
10,188,130,58,5,170,132,38,5,261,1325,2
1,166,133,33,5,164,133,31,5,249,2114,2
2,175,133,42,5,144,115,29,5,249,2114,2
3,180,131,49,5,136,111,25,5,249,2114,2
4,171,125,46,5,117,96,21,5,249,2114,2
5,169,131,38,5,154,127,27,5,249,2114,2
6,174,124,50,5,177,147,30,5,249,2114,2
7,167,128,39,5,162,135,27,5,249,2114,2
8,173,127,46,5,180,146,34,5,249,2114,2
9,172,126,46,5,174,144,30,5,249,2114,2
10,178,133,45,5,151,117,34,5,249,2114,2
1,196,161,35,5,207,190,17,5,49,3334,2
2,196,164,32,5,215,194,21,5,49,3334,2
3,194,160,34,5,208,192,16,5,49,3334,2
4,197,165,32,5,211,191,20,5,49,3334,2
5,195,164,31,5,209,189,20,5,49,3334,2
6,197,161,36,5,210,190,20,5,49,3334,2
7,196,164,32,5,207,188,19,5,49,3334,2
8,195,162,33,5,212,189,23,5,49,3334,2
9,194,158,36,5,207,187,20,5,49,3334,2
10,194,164,30,5,204,190,14,5,49,3334,2
1,124,68,56,5,98,63,35,5,435,2470,2
2,129,67,62,5,88,54,34,5,435,2470,2
3,120,66,54,5,96,64,32,5,435,2470,2
4,125,62,63,5,80,55,25,5,435,2470,2
5,121,66,55,5,80,55,25,5,435,2470,2
6,137,67,70,5,80,55,25,5,435,2470,2
7,120,67,53,5,89,60,29,5,435,2470,2
8,117,65,52,5,95,62,33,5,435,2470,2
9,118,68,50,5,118,72,46,5,435,2470,2
10,129,67,62,5,84,53,31,5,435,2470,2
1,196,161,35,5,207,190,17,5,72,1433,2
2,196,164,32,5,215,194,21,5,72,1433,2
3,194,160,34,5,208,192,16,5,72,1433,2
4,197,165,32,5,211,191,20,5,72,1433,2
5,195,164,31,5,209,189,20,5,72,1433,2
6,197,161,36,5,210,190,20,5,72,1433,2
7,196,164,32,5,207,188,19,5,72,1433,2
8,195,162,33,5,212,189,23,5,72,1433,2
9,194,158,36,5,207,187,20,5,72,1433,2
10,194,164,30,5,204,190,14,5,72,1433,2
1,165,123,42,5,169,137,32,5,224,160,2
2,163,122,41,5,141,114,27,5,224,160,2
3,164,122,42,5,124,102,22,5,224,160,2
4,167,116,51,5,141,115,26,5,224,160,2
5,164,120,44,5,184,148,36,5,224,160,2
6,166,124,42,5,187,153,34,5,224,160,2
7,163,121,42,5,135,112,23,5,224,160,2
8,161,121,40,5,147,122,25,5,224,160,2
9,167,123,44,5,177,144,33,5,224,160,2
10,165,124,41,5,163,132,31,5,224,160,2
1,159,123,36,5,178,148,30,5,214,3805,2
2,162,122,40,5,148,124,24,5,214,3805,2
3,162,120,42,5,181,150,31,5,214,3805,2
4,164,121,43,5,132,109,23,5,214,3805,2
5,174,123,51,5,158,127,31,5,214,3805,2
6,169,122,47,5,169,137,32,5,214,3805,2
7,164,126,38,5,117,95,22,5,214,3805,2
8,160,118,42,5,181,142,39,5,214,3805,2
9,162,118,44,5,127,104,23,5,214,3805,2
10,158,125,33,5,178,145,33,5,214,3805,2
